년도,월,일,사용분야,수입지출여부,금액,총금액
2022,11,25,쇼핑,수입,3819,3819
2022,2,28,식사,지출,2827,992
2022,4,23,체육대회,수입,6818,7810
2020,1,8,체육대회,수입,2804,10614
2021,9,14,MT,지출,2156,8458
2020,12,17,쇼핑,수입,2581,11039
2021,10,19,여행,지출,3500,7539
2021,12,5,쇼핑,수입,9267,16806
2020,2,24,체육대회,수입,1108,17914
2023,9,10,여행,수입,9047,26961
2020,1,28,식사,수입,8897,35858
2023,11,11,쇼핑,수입,4977,40835
2021,7,9,쇼핑,수입,7492,48327
2020,5,3,쇼핑,지출,9388,38939
2021,3,10,식사,수입,8679,47618
2021,4,1,식사,수입,7259,54877
2021,10,18,쇼핑,지출,2494,52383
2020,8,6,체육대회,지출,8292,44091
2022,5,23,쇼핑,수입,2930,47021
2022,10,16,쇼핑,수입,7285,54306
2023,3,5,식사,지출,9364,44942
2021,1,17,MT,수입,3531,48473
2020,5,27,쇼핑,수입,6101,54574
2020,6,15,쇼핑,지출,9929,44645
2020,8,19,MT,지출,7050,37595
2021,11,11,식사,수입,2168,39763
2021,8,29,쇼핑,수입,1692,41455
2021,12,7,식사,지출,9943,31512
2023,2,6,쇼핑,지출,2387,29125
2023,11,14,여행,수입,9750,38875
2021,5,1,식사,수입,9461,48336
2021,3,21,MT,수입,4790,53126
2021,8,15,체육대회,지출,9622,43504
2022,7,22,여행,수입,9496,53000
2023,2,26,쇼핑,수입,8371,61371
2023,10,25,여행,지출,6064,55307
2022,5,1,체육대회,수입,3820,59127
2023,6,30,쇼핑,지출,3911,55216
2020,5,24,식사,수입,8931,64147
2021,6,3,체육대회,수입,5816,69963
2022,8,3,여행,수입,8748,78711
2021,6,1,여행,수입,4118,82829
2021,6,16,체육대회,수입,9884,92713
2021,2,24,체육대회,수입,9654,102367
2020,10,30,식사,수입,3502,105869
2021,2,25,쇼핑,지출,6295,99574
2020,10,6,식사,지출,5706,93868
2020,7,31,체육대회,수입,4152,98020
2021,11,28,체육대회,수입,8665,106685
2022,7,17,MT,수입,9598,116283
2023,8,11,여행,지출,1891,114392
2023,5,12,쇼핑,수입,2292,116684
2022,8,14,MT,지출,7975,108709
2022,7,15,쇼핑,지출,5493,103216
2022,12,15,MT,수입,9488,112704
2021,2,7,쇼핑,수입,3836,116540
2022,8,10,MT,수입,1139,117679
2023,4,12,MT,지출,9560,108119
2023,3,15,쇼핑,지출,5287,102832
2023,8,16,체육대회,수입,9797,112629
2021,7,9,쇼핑,수입,3280,115909
2021,1,30,MT,지출,4890,111019
2020,7,4,여행,수입,6708,117727
2021,5,31,여행,지출,1082,116645
2022,9,11,여행,지출,2616,114029
2022,3,31,MT,지출,4772,109257
2023,11,24,쇼핑,수입,7018,116275
2020,9,1,식사,수입,9444,125719
2023,7,4,체육대회,지출,6050,119669
2020,5,22,식사,지출,3230,116439
2023,5,8,MT,지출,3288,113151
2020,4,30,체육대회,수입,6580,119731
2022,8,16,MT,수입,2069,121800
2022,6,20,MT,수입,5006,126806
2020,4,26,식사,수입,8049,134855
2022,11,26,MT,수입,3237,138092
2020,2,1,쇼핑,지출,9459,128633
2022,8,22,식사,지출,4469,124164
2020,1,7,쇼핑,지출,8178,115986
2021,4,22,MT,수입,9686,125672
2020,2,27,여행,수입,5157,130829
2023,1,8,체육대회,수입,4611,135440
2021,4,2,쇼핑,수입,3711,139151
2020,11,1,여행,수입,9177,148328
2023,1,12,여행,지출,5250,143078
2022,6,12,식사,수입,8821,151899
2020,8,7,여행,수입,5373,157272
2020,5,14,MT,지출,4492,152780
2021,2,7,쇼핑,수입,6207,158987
2022,11,6,여행,지출,1006,157981
2021,9,10,MT,지출,8423,149558
2022,1,24,MT,수입,3083,152641
2023,8,15,체육대회,수입,9823,162464
2023,4,9,MT,지출,5445,157019
2023,11,30,MT,수입,8057,165076
2020,4,14,식사,수입,2331,167407
2023,4,19,여행,수입,4772,172179
2020,6,4,식사,수입,5368,177547
2020,7,14,식사,수입,6198,183745
2023,4,17,여행,수입,6058,189803
2020,3,3,쇼핑,수입,1609,191412
2020,2,27,MT,지출,7680,183732
2022,1,21,체육대회,지출,9483,174249
2020,7,30,MT,지출,9287,164962
2023,9,6,체육대회,수입,9731,174693
2020,8,6,MT,지출,6454,168239
2020,7,8,MT,지출,3698,164541
2023,7,27,여행,수입,8614,173155
2020,9,23,MT,수입,6518,179673
2022,4,14,MT,지출,2995,176678
2022,2,12,식사,지출,8531,168147
2020,7,16,식사,지출,9296,158851
2022,7,8,체육대회,수입,8240,167091
2023,5,28,쇼핑,지출,5211,161880
2020,4,2,식사,수입,4391,166271
2021,9,20,쇼핑,지출,1720,164551
2020,9,30,MT,지출,8684,155867
2022,1,30,체육대회,지출,6494,149373
2021,8,16,식사,수입,1032,150405
2021,11,20,MT,수입,7169,157574
2023,1,9,MT,지출,7349,150225
2023,10,17,쇼핑,지출,2293,147932
2021,2,26,MT,수입,2235,150167
2020,7,10,MT,수입,1604,151771
2023,10,6,체육대회,수입,2583,154354
2023,9,25,여행,수입,7992,162346
2020,10,6,쇼핑,지출,2531,159815
2022,12,23,여행,지출,5168,154647
2023,10,24,MT,지출,9424,145223
2022,10,23,여행,지출,1145,144078
2023,2,7,체육대회,수입,6640,150718
2023,3,24,쇼핑,수입,4316,155034
2021,6,10,체육대회,지출,2555,152479
2021,4,8,체육대회,수입,4478,156957
2023,11,15,여행,수입,1595,158552
2020,1,9,여행,지출,8984,149568
2020,1,12,체육대회,지출,7272,142296
2020,5,15,체육대회,수입,4800,147096
2021,6,16,쇼핑,수입,8465,155561
2021,4,1,여행,수입,9288,164849
2023,2,10,체육대회,수입,3857,168706
2020,1,3,MT,지출,5130,163576
2022,9,26,식사,지출,8328,155248
2020,1,3,체육대회,수입,6975,162223
2022,10,29,여행,지출,5082,157141
2023,11,26,식사,지출,9295,147846
2020,3,28,식사,수입,6734,154580
2023,1,5,쇼핑,수입,4330,158910
2023,10,29,MT,지출,4869,154041
2021,5,23,식사,수입,8684,162725
2023,5,5,식사,수입,9559,172284
2021,11,26,체육대회,지출,8825,163459
2022,5,16,MT,수입,5696,169155
2021,2,21,MT,수입,8640,177795
2023,7,4,식사,지출,6857,170938
2023,4,10,쇼핑,지출,9370,161568
2023,8,24,여행,수입,3659,165227
2023,3,5,MT,지출,9855,155372
2022,9,25,식사,지출,1225,154147
2022,9,22,식사,지출,9538,144609
2023,8,25,식사,지출,4011,140598
2022,11,18,쇼핑,지출,7852,132746
2021,7,28,체육대회,지출,1269,131477
2022,1,24,식사,수입,5020,136497
2022,11,25,여행,지출,7862,128635
2023,2,2,쇼핑,지출,3789,124846
2022,10,11,여행,수입,6778,131624
2021,5,27,체육대회,수입,7478,139102
2023,9,30,쇼핑,지출,7209,131893
2020,11,3,여행,수입,2202,134095
2023,8,16,MT,지출,9288,124807
2020,5,28,MT,지출,3807,121000
2023,2,20,여행,지출,9900,111100
2022,4,20,MT,지출,2586,108514
2023,7,25,MT,지출,3640,104874
2021,7,16,여행,지출,9216,95658
2023,8,20,MT,수입,7257,102915
2022,7,31,쇼핑,수입,6896,109811
2020,9,3,여행,수입,6922,116733
2020,7,13,여행,수입,9021,125754
2022,2,13,체육대회,수입,9013,134767
2023,12,15,식사,지출,6994,127773
2022,7,26,여행,수입,3955,131728
2023,9,12,체육대회,수입,8486,140214
2023,7,14,체육대회,수입,3837,144051
2022,1,11,여행,지출,6946,137105
2021,12,4,쇼핑,지출,8295,128810
2022,9,7,체육대회,수입,3698,132508
2023,6,14,여행,수입,3135,135643
2022,8,20,여행,지출,7429,128214
2021,9,9,쇼핑,수입,6327,134541
2022,8,12,식사,수입,5029,139570
2023,11,14,쇼핑,수입,2382,141952
2020,4,19,MT,지출,7635,134317
2023,6,2,여행,수입,5609,139926
2022,4,8,체육대회,지출,5712,134214
2020,11,6,쇼핑,수입,2814,137028
2021,11,28,여행,수입,2167,139195
2020,5,6,체육대회,지출,8961,130234
2023,11,25,MT,수입,4961,135195
2022,11,6,여행,수입,9415,144610
2023,10,19,여행,지출,5569,139041
2021,8,5,식사,지출,3887,135154
2020,10,22,여행,수입,4188,139342
2021,11,5,MT,지출,6015,133327
2023,7,1,여행,수입,4704,138031
2022,5,18,식사,지출,3154,134877
2022,10,11,식사,지출,7034,127843
2023,2,1,쇼핑,지출,7999,119844
2023,5,8,MT,지출,9618,110226
2020,9,23,체육대회,수입,2029,112255
2023,10,13,MT,지출,7065,105190
2020,10,7,식사,수입,7854,113044
2022,5,5,체육대회,지출,1446,111598
2021,9,30,쇼핑,수입,5617,117215
2023,2,20,MT,지출,9497,107718
2020,4,29,여행,수입,6446,114164
2020,7,4,쇼핑,지출,5654,108510
2023,8,17,식사,수입,5265,113775
2020,4,14,여행,수입,8448,122223
2023,4,15,식사,수입,7735,129958
2023,12,12,식사,지출,2765,127193
2021,5,27,쇼핑,지출,4931,122262
2020,9,16,체육대회,지출,1834,120428
2020,4,19,쇼핑,수입,1058,121486
2021,10,28,여행,수입,6221,127707
2022,6,16,체육대회,지출,8079,119628
2023,5,9,식사,수입,7485,127113
2020,5,25,식사,수입,5679,132792
2021,2,17,쇼핑,지출,7353,125439
2021,11,12,여행,지출,7380,118059
2023,12,29,MT,지출,1907,116152
2023,11,29,식사,수입,6061,122213
2022,10,13,쇼핑,수입,6115,128328
2020,9,28,식사,지출,3464,124864
2021,5,24,식사,수입,1876,126740
2022,1,23,MT,수입,7365,134105
2022,3,12,여행,수입,8771,142876
2023,8,15,여행,지출,8761,134115
2022,6,2,MT,수입,6067,140182
2022,3,14,체육대회,수입,6714,146896
2020,6,18,쇼핑,수입,4235,151131
2022,3,11,여행,지출,8673,142458
2021,9,20,쇼핑,지출,2739,139719
2022,4,15,쇼핑,지출,1126,138593
2023,12,12,쇼핑,수입,6789,145382
2023,7,23,쇼핑,지출,8706,136676
2022,4,19,쇼핑,수입,5784,142460
2022,5,15,여행,지출,1267,141193
2021,7,9,식사,수입,7891,149084
2020,12,6,MT,지출,9530,139554
2021,6,26,여행,수입,1349,140903
2021,5,26,여행,지출,1066,139837
2022,5,15,MT,지출,9014,130823
2021,1,16,쇼핑,수입,9717,140540
2023,11,2,여행,지출,1739,138801
2022,12,6,쇼핑,수입,6423,145224
2023,10,18,쇼핑,지출,2712,142512
2021,11,6,쇼핑,수입,4812,147324
2022,6,19,여행,수입,3861,151185
2023,4,22,체육대회,지출,9871,141314
2020,2,7,체육대회,지출,7630,133684
2023,5,22,체육대회,수입,4469,138153
2022,7,8,여행,수입,3730,141883
2020,4,3,식사,수입,9753,151636
2023,10,17,체육대회,수입,9151,160787
2020,9,27,식사,지출,3992,156795
2021,12,26,쇼핑,수입,2540,159335
2021,12,24,MT,수입,8705,168040
2021,12,15,쇼핑,수입,8238,176278
2020,9,19,식사,지출,3079,173199
2021,6,28,쇼핑,수입,2417,175616
2022,11,4,식사,수입,9394,185010
2021,2,24,식사,지출,3611,181399
2023,11,10,MT,지출,2711,178688
2022,8,17,MT,지출,4851,173837
2022,9,15,MT,수입,7349,181186
2020,5,19,여행,지출,5541,175645
2022,4,14,여행,수입,8174,183819
2022,7,25,MT,수입,1335,185154
2020,2,21,체육대회,지출,3901,181253
2022,10,1,쇼핑,지출,1557,179696
2021,6,9,쇼핑,지출,9796,169900
2021,7,9,MT,수입,5933,175833
2020,5,13,MT,지출,2797,173036
2023,10,28,여행,지출,3991,169045
2022,9,3,MT,지출,5362,163683
2023,3,5,체육대회,지출,4476,159207
2023,6,30,MT,지출,8328,150879
2022,10,23,식사,수입,9447,160326
2022,4,11,여행,지출,6644,153682
2021,4,29,여행,수입,7591,161273
2022,10,14,쇼핑,수입,8518,169791
2023,2,24,MT,지출,2764,167027
2021,3,17,여행,지출,1104,165923
2020,8,9,쇼핑,지출,3107,162816
2022,3,8,식사,지출,3261,159555
2021,1,3,여행,지출,9986,149569
2023,12,8,여행,지출,7809,141760
2023,5,19,쇼핑,수입,4741,146501
2022,12,24,체육대회,수입,7552,154053
2023,3,16,쇼핑,수입,6507,160560
2021,7,5,MT,수입,1916,162476
2020,3,31,여행,지출,1218,161258
2022,3,29,쇼핑,수입,9163,170421
2020,12,30,MT,지출,2800,167621
2023,5,17,쇼핑,지출,3287,164334
2023,6,27,MT,수입,6440,170774
2023,1,22,체육대회,수입,3865,174639
2020,5,25,MT,수입,2450,177089
2020,9,12,쇼핑,수입,7024,184113
2023,5,27,여행,지출,7923,176190
2020,2,7,여행,지출,2541,173649
2022,12,3,여행,지출,3508,170141
2020,10,31,여행,지출,4412,165729
2020,5,14,여행,수입,4751,170480
2021,8,2,쇼핑,수입,4374,174854
2022,10,30,체육대회,수입,2566,177420
2020,3,11,체육대회,지출,9445,167975
2022,7,5,여행,지출,6656,161319
2020,4,18,체육대회,지출,4310,157009
2020,1,17,쇼핑,수입,7156,164165
2020,1,22,식사,지출,2292,161873
2020,12,8,쇼핑,지출,7837,154036
2021,6,17,체육대회,지출,3429,150607
2022,11,23,체육대회,수입,2135,152742
2021,12,30,여행,지출,3156,149586
2023,3,28,여행,지출,6208,143378
2020,2,11,여행,수입,3594,146972
2021,5,30,MT,수입,4135,151107
2022,2,22,MT,수입,5516,156623
2021,6,11,여행,수입,9089,165712
2020,6,25,여행,지출,3014,162698
2020,2,6,쇼핑,지출,7404,155294
2020,10,7,식사,수입,7038,162332
2022,4,21,MT,수입,5495,167827
2022,5,22,쇼핑,수입,8427,176254
2022,8,12,쇼핑,수입,5351,181605
2023,12,29,식사,수입,4183,185788
2023,9,20,쇼핑,지출,7492,178296
2023,7,14,쇼핑,지출,5673,172623
2020,10,24,체육대회,수입,4293,176916
2021,8,19,여행,지출,5872,171044
2021,8,18,쇼핑,수입,8440,179484
2020,3,12,식사,수입,3598,183082
2023,1,16,식사,수입,3126,186208
2023,7,8,쇼핑,수입,9020,195228
2022,9,25,체육대회,지출,6344,188884
2022,6,26,식사,지출,2741,186143
2020,3,2,여행,수입,6873,193016
2022,3,21,쇼핑,지출,6279,186737
2022,10,6,MT,수입,1601,188338
2020,6,18,여행,지출,4210,184128
2022,1,6,MT,수입,9523,193651
2022,9,20,쇼핑,지출,7591,186060
2022,9,20,여행,지출,6249,179811
2022,12,20,쇼핑,수입,4675,184486
2021,3,12,쇼핑,수입,3727,188213
2021,6,9,식사,수입,1781,189994
2022,5,28,체육대회,지출,2754,187240
2023,9,4,쇼핑,지출,2143,185097
2022,2,1,여행,지출,7276,177821
2023,9,24,MT,지출,3441,174380
2023,5,12,식사,수입,4785,179165
2020,2,8,체육대회,지출,1120,178045
2020,8,4,MT,수입,5345,183390
2023,2,26,여행,지출,4997,178393
2023,12,19,쇼핑,수입,5582,183975
2022,1,9,여행,지출,2612,181363
2022,1,3,체육대회,수입,2673,184036
2020,10,17,식사,수입,4666,188702
2022,7,28,쇼핑,지출,8710,179992
2023,12,10,MT,수입,7934,187926
2022,11,28,쇼핑,수입,8942,196868
2021,4,9,여행,지출,8776,188092
2022,9,19,여행,수입,7418,195510
2020,10,25,쇼핑,수입,7140,202650
2021,5,30,식사,수입,3756,206406
2023,3,6,식사,지출,5338,201068
2022,6,2,쇼핑,수입,2980,204048
2021,1,4,MT,지출,9719,194329
2022,3,21,식사,지출,2547,191782
2020,6,1,쇼핑,지출,3482,188300
2021,12,31,여행,수입,2354,190654
2023,2,24,식사,지출,3006,187648
2023,6,4,체육대회,지출,8594,179054
2022,12,6,여행,수입,4957,184011
2023,6,2,식사,지출,1184,182827
2023,4,11,체육대회,수입,4881,187708
2023,8,3,체육대회,지출,2138,185570
2021,2,18,체육대회,지출,4598,180972
2021,5,1,여행,수입,5126,186098
2023,3,26,여행,수입,7527,193625
2023,7,18,체육대회,수입,6038,199663
2022,11,23,MT,수입,4272,203935
2020,9,19,체육대회,지출,5793,198142
2022,11,7,체육대회,수입,2314,200456
2023,9,23,MT,지출,5240,195216
2020,10,10,체육대회,수입,5114,200330
2023,11,21,여행,수입,1346,201676
2022,5,5,식사,수입,9895,211571
2021,8,3,MT,수입,5475,217046
2023,3,11,식사,지출,6003,211043
2021,7,8,쇼핑,지출,9646,201397
2022,9,21,식사,수입,4068,205465
2020,2,14,체육대회,수입,5386,210851
2020,2,2,여행,지출,9938,200913
2022,4,28,쇼핑,지출,4985,195928
2022,9,20,MT,지출,3339,192589
2022,3,7,MT,수입,2758,195347
2022,5,9,MT,지출,5115,190232
2020,5,23,MT,지출,5471,184761
2022,2,15,체육대회,수입,7208,191969
2020,2,28,여행,수입,3068,195037
2021,5,18,쇼핑,지출,4251,190786
2021,1,20,쇼핑,지출,7639,183147
2020,1,21,체육대회,지출,2840,180307
2021,10,26,쇼핑,지출,9279,171028
2022,4,24,여행,지출,6068,164960
2021,12,15,쇼핑,지출,7229,157731
2023,1,21,체육대회,지출,8209,149522
2022,8,24,쇼핑,수입,4986,154508
2021,7,25,여행,수입,7533,162041
2021,9,8,식사,수입,1538,163579
2022,7,18,MT,지출,1872,161707
2022,12,12,식사,수입,5572,167279
2022,12,1,MT,수입,4880,172159
2022,10,31,식사,수입,3486,175645
2020,5,23,쇼핑,수입,3275,178920
2022,2,23,MT,수입,1506,180426
2023,6,25,MT,수입,6971,187397
2020,8,15,쇼핑,지출,9693,177704
2023,11,17,쇼핑,수입,2067,179771
2020,9,12,쇼핑,수입,3492,183263
2023,9,17,쇼핑,수입,4767,188030
2022,9,18,체육대회,지출,2112,185918
2021,12,1,MT,지출,7635,178283
2022,7,1,여행,지출,8294,169989
2022,1,18,여행,수입,7792,177781
2022,5,6,여행,지출,3293,174488
2023,8,5,식사,수입,6774,181262
2020,8,25,체육대회,수입,2907,184169
2023,1,5,체육대회,수입,7576,191745
2022,2,27,식사,수입,9640,201385
2023,10,31,식사,수입,4034,205419
2023,12,1,체육대회,수입,2038,207457
2023,11,26,쇼핑,지출,1313,206144
2021,6,9,쇼핑,지출,5330,200814
2022,11,27,쇼핑,수입,9910,210724
2023,4,16,여행,수입,9069,219793
2023,5,7,MT,지출,3829,215964
2023,11,27,쇼핑,지출,4997,210967
2021,6,26,쇼핑,수입,7357,218324
2022,3,12,여행,수입,4150,222474
2020,6,12,체육대회,지출,6670,215804
2021,11,3,체육대회,수입,1625,217429
2022,10,21,MT,수입,1594,219023
2021,12,1,MT,수입,2944,221967
2023,12,27,체육대회,수입,8091,230058
2021,5,16,체육대회,수입,2540,232598
2021,8,12,MT,수입,7105,239703
2021,4,30,MT,지출,9990,229713
2020,3,6,여행,지출,1525,228188
2023,5,2,여행,지출,6758,221430
2022,3,17,식사,수입,2601,224031
2020,8,2,식사,수입,2600,226631
2023,6,11,쇼핑,지출,6441,220190
2022,4,18,쇼핑,지출,4645,215545
2023,4,9,쇼핑,지출,5491,210054
2020,7,3,체육대회,지출,2093,207961
2022,10,6,식사,수입,6594,214555
2022,10,15,체육대회,수입,9230,223785
2023,9,26,체육대회,지출,7474,216311
2022,12,4,식사,수입,8194,224505
2022,6,23,MT,지출,8942,215563
2022,9,1,체육대회,지출,2966,212597
2022,11,21,식사,지출,5366,207231
2023,10,5,쇼핑,수입,3158,210389
2020,4,23,MT,지출,7066,203323
2023,6,20,식사,지출,1707,201616
2022,8,3,식사,수입,6066,207682
2023,9,2,여행,수입,4216,211898
2023,12,20,MT,지출,3416,208482
2020,11,6,식사,지출,5431,203051
2023,6,10,여행,수입,6341,209392
2023,7,3,쇼핑,지출,2751,206641
2022,10,17,MT,수입,5083,211724
2022,3,6,MT,수입,2863,214587
2023,4,3,쇼핑,수입,9463,224050
2023,8,3,여행,수입,5599,229649
2020,9,29,식사,수입,1911,231560
2022,5,27,체육대회,수입,6696,238256
2023,11,15,쇼핑,지출,1637,236619
2023,2,6,쇼핑,지출,9388,227231
2021,5,6,체육대회,수입,9233,236464
2020,5,8,체육대회,수입,4895,241359
2021,9,27,MT,수입,5857,247216
2023,3,20,여행,수입,7689,254905
2021,10,7,여행,수입,2849,257754
2023,4,2,쇼핑,지출,3130,254624
2023,3,16,쇼핑,지출,1487,253137
2022,10,16,체육대회,수입,7756,260893
2022,8,11,식사,지출,3112,257781
2022,1,9,여행,지출,3131,254650
2020,1,11,MT,수입,5031,259681
2022,6,22,식사,지출,9336,250345
2021,2,18,체육대회,지출,4550,245795
2022,1,6,식사,지출,6193,239602
2021,1,29,식사,수입,9413,249015
2021,12,6,식사,수입,2891,251906
2022,3,5,MT,지출,6990,244916
2022,7,27,체육대회,지출,8372,236544
2021,11,30,체육대회,수입,8636,245180
2023,3,29,체육대회,지출,2908,242272
2022,7,3,여행,지출,4324,237948
2023,9,12,쇼핑,수입,7742,245690
2022,3,17,체육대회,지출,3389,242301
2020,4,1,여행,수입,2693,244994
2020,6,1,여행,지출,3614,241380
2021,2,26,체육대회,지출,7264,234116
2020,4,9,쇼핑,지출,8113,226003
2023,7,4,쇼핑,지출,7052,218951
2023,9,8,체육대회,수입,9753,228704
2021,4,12,식사,지출,8458,220246
2020,7,12,MT,지출,4406,215840
2023,11,11,MT,지출,9694,206146
2023,7,24,쇼핑,지출,8895,197251
2022,8,20,여행,지출,8461,188790
2023,11,14,쇼핑,지출,4606,184184
2020,12,15,식사,수입,9553,193737
2023,4,20,식사,수입,6113,199850
2023,11,23,쇼핑,지출,3176,196674
2021,11,11,여행,수입,2057,198731
2021,7,12,식사,지출,7549,191182
2020,10,7,여행,지출,9703,181479
2022,10,21,식사,지출,7617,173862
2022,5,7,체육대회,수입,8260,182122
2020,7,17,식사,수입,8252,190374
2021,10,21,체육대회,지출,4458,185916
2021,12,1,여행,수입,5935,191851
2022,1,12,체육대회,지출,8014,183837
2022,8,31,식사,지출,7464,176373
2023,6,11,쇼핑,수입,6359,182732
2021,4,10,쇼핑,지출,9006,173726
2023,8,30,여행,수입,6290,180016
2023,5,26,여행,지출,1832,178184
2021,3,23,MT,수입,2943,181127
2020,1,19,여행,수입,3455,184582
2022,1,19,쇼핑,수입,1673,186255
2021,3,1,쇼핑,수입,3784,190039
2023,12,8,식사,지출,5109,184930
2023,9,12,여행,수입,8512,193442
2020,9,4,체육대회,수입,6239,199681
2020,4,19,여행,지출,6427,193254
2021,8,3,MT,수입,7290,200544
2022,3,1,여행,수입,7761,208305
2022,11,14,체육대회,지출,1022,207283
2022,11,18,체육대회,수입,9482,216765
2022,10,14,쇼핑,지출,3632,213133
2020,8,24,체육대회,수입,2499,215632
2023,10,24,체육대회,지출,2540,213092
2023,1,1,여행,지출,2771,210321
2023,1,22,여행,지출,9593,200728
2021,1,21,식사,수입,7719,208447
2023,9,2,MT,지출,5420,203027
2021,6,14,MT,지출,4053,198974
2020,5,7,MT,수입,3861,202835
2023,1,11,쇼핑,지출,2914,199921
2023,9,28,여행,지출,8679,191242
2021,6,14,식사,수입,8961,200203
2023,12,24,여행,수입,6557,206760
2021,4,27,체육대회,지출,2066,204694
2023,8,22,쇼핑,수입,8430,213124
2021,4,10,MT,수입,2688,215812
2023,4,26,체육대회,지출,2105,213707
2023,12,20,식사,지출,1275,212432
2020,11,15,MT,수입,1046,213478
2023,10,5,쇼핑,수입,4013,217491
2023,6,1,식사,수입,1104,218595
2021,3,9,체육대회,수입,8909,227504
2023,10,29,식사,수입,7136,234640
2020,9,2,MT,지출,9555,225085
2022,12,3,여행,지출,7950,217135
2022,10,13,체육대회,수입,6037,223172
2020,10,5,식사,수입,7849,231021
2021,7,9,쇼핑,지출,1356,229665
2023,7,29,쇼핑,수입,2613,232278
2022,3,15,여행,지출,8208,224070
2022,1,20,여행,수입,1515,225585
2022,9,7,MT,지출,5449,220136
2020,5,22,여행,수입,8422,228558
2023,1,24,체육대회,지출,3573,224985
2023,6,21,여행,수입,8309,233294
2023,9,25,체육대회,지출,4023,229271
2023,7,18,쇼핑,수입,5667,234938
2022,5,29,MT,지출,8806,226132
2022,2,1,여행,지출,1742,224390
2023,6,3,여행,수입,1641,226031
2022,8,21,MT,지출,7840,218191
2021,10,7,식사,지출,5998,212193
2023,9,14,쇼핑,지출,5229,206964
2022,12,29,쇼핑,수입,8760,215724
2021,3,6,식사,수입,5753,221477
2022,9,18,식사,지출,5043,216434
2023,12,17,식사,수입,9895,226329
2021,7,13,쇼핑,수입,9497,235826
2023,7,22,식사,수입,2287,238113
2020,1,10,MT,수입,6485,244598
2021,5,15,쇼핑,지출,4100,240498
2020,1,11,MT,지출,7080,233418
2023,2,22,식사,수입,6894,240312
2020,4,13,쇼핑,지출,6673,233639
2023,3,19,MT,수입,9352,242991
2022,1,8,여행,수입,8861,251852
2020,8,13,MT,지출,4348,247504
2023,8,9,체육대회,지출,1887,245617
2023,12,30,쇼핑,지출,9550,236067
2020,6,21,여행,지출,1451,234616
2021,7,25,쇼핑,수입,7726,242342
2023,3,6,체육대회,수입,4790,247132
2020,12,28,쇼핑,지출,9329,237803
2021,11,22,식사,지출,7278,230525
2023,8,27,식사,수입,3972,234497
2020,12,3,체육대회,수입,1050,235547
2020,10,16,체육대회,수입,5226,240773
2021,11,14,쇼핑,수입,9366,250139
2020,11,30,쇼핑,수입,4553,254692
2023,6,5,식사,지출,8207,246485
2022,12,11,식사,수입,1619,248104
2021,8,5,쇼핑,수입,2899,251003
2020,5,24,체육대회,지출,6605,244398
2022,7,22,식사,수입,7477,251875
2022,12,11,식사,지출,4170,247705
2021,5,2,여행,지출,4979,242726
2020,10,21,식사,수입,9988,252714
2021,1,1,MT,수입,3410,256124
2022,2,27,쇼핑,수입,6830,262954
2023,10,31,식사,지출,1369,261585
2023,8,15,여행,지출,3756,257829
2022,3,20,쇼핑,지출,1429,256400
2020,8,26,MT,수입,6676,263076
2020,12,18,체육대회,지출,4745,258331
2023,11,6,MT,수입,5295,263626
2020,1,8,식사,지출,9575,254051
2022,2,18,여행,수입,9707,263758
2021,9,19,식사,수입,7448,271206
2023,3,10,식사,지출,3105,268101
2021,10,20,쇼핑,수입,2344,270445
2022,2,23,여행,지출,7934,262511
2021,6,17,식사,지출,4997,257514
2020,5,12,식사,수입,9366,266880
2021,11,17,MT,지출,8802,258078
2020,6,8,체육대회,지출,1889,256189
2020,11,5,식사,지출,6883,249306
2021,11,27,여행,지출,7097,242209
2021,4,15,식사,수입,7520,249729
2022,8,1,쇼핑,수입,6516,256245
2022,12,29,식사,지출,8204,248041
2022,11,26,체육대회,수입,1982,250023
2021,4,27,MT,지출,8515,241508
2022,3,5,MT,수입,8239,249747
2022,3,19,체육대회,지출,9226,240521
2023,7,22,식사,지출,8746,231775
2021,5,15,MT,수입,3932,235707
2020,4,1,체육대회,수입,1770,237477
2020,8,5,MT,수입,7758,245235
2023,11,22,쇼핑,지출,2442,242793
2021,12,23,MT,수입,6255,249048
2020,2,11,체육대회,지출,8034,241014
2021,7,30,체육대회,수입,9211,250225
2020,8,11,체육대회,수입,7664,257889
2021,6,24,식사,수입,7003,264892
2021,4,6,여행,수입,5393,270285
2020,1,11,MT,지출,1669,268616
2022,4,2,MT,지출,9170,259446
2020,9,11,체육대회,수입,1150,260596
2020,12,6,쇼핑,지출,2476,258120
2023,7,26,MT,지출,9578,248542
2021,7,15,체육대회,수입,3927,252469
2023,3,20,쇼핑,수입,8747,261216
2023,7,24,MT,수입,9789,271005
2022,12,21,식사,지출,7290,263715
2020,11,17,쇼핑,수입,8838,272553
2020,10,1,MT,수입,9893,282446
2022,3,10,체육대회,지출,2649,279797
2020,11,28,MT,수입,7016,286813
2021,12,13,MT,수입,4037,290850
2021,6,3,MT,지출,2416,288434
2023,5,7,MT,수입,8341,296775
2023,11,1,MT,수입,6687,303462
2022,5,16,체육대회,지출,5489,297973
2022,8,7,여행,수입,7768,305741
2023,11,28,MT,지출,3267,302474
2021,12,4,체육대회,지출,5768,296706
2020,2,28,식사,수입,5183,301889
2020,9,28,쇼핑,지출,2532,299357
2021,2,15,MT,지출,3757,295600
2022,4,26,체육대회,수입,6772,302372
2020,2,12,여행,지출,2331,300041
2022,1,15,체육대회,지출,1137,298904
2022,4,28,쇼핑,수입,3064,301968
2021,10,28,MT,지출,6032,295936
2023,5,17,MT,지출,8809,287127
2022,10,11,여행,지출,9053,278074
2021,4,19,쇼핑,수입,4793,282867
2021,5,12,쇼핑,지출,6681,276186
2021,10,21,체육대회,지출,1767,274419
2020,4,27,식사,수입,4284,278703
2022,10,10,식사,수입,2922,281625
2021,4,4,식사,지출,5242,276383
2023,5,6,여행,수입,8209,284592
2023,1,20,여행,지출,9895,274697
2022,7,29,MT,지출,2284,272413
2022,6,15,식사,지출,1104,271309
2021,8,28,여행,수입,8419,279728
2021,3,13,쇼핑,수입,3251,282979
2023,12,28,식사,수입,7409,290388
2022,3,24,체육대회,지출,4527,285861
2021,6,21,쇼핑,지출,1782,284079
2022,1,20,여행,수입,6169,290248
2020,11,16,여행,지출,5910,284338
2021,11,16,체육대회,지출,6987,277351
2023,7,20,여행,수입,2383,279734
2022,9,10,쇼핑,수입,5792,285526
2020,6,5,쇼핑,수입,3939,289465
2021,9,13,MT,지출,3640,285825
2021,7,11,쇼핑,지출,8301,277524
2021,5,8,MT,지출,4080,273444
2022,2,27,식사,지출,4366,269078
2021,3,28,체육대회,지출,1646,267432
2022,4,27,식사,수입,7800,275232
2023,3,19,쇼핑,지출,8143,267089
2022,3,11,MT,수입,8493,275582
2021,6,16,여행,지출,6803,268779
2023,12,26,MT,지출,7020,261759
2021,2,22,여행,수입,5688,267447
2022,10,25,여행,지출,4252,263195
2022,2,19,여행,수입,5209,268404
2023,6,26,MT,수입,4493,272897
2021,6,9,식사,지출,3049,269848
2021,4,14,여행,지출,7738,262110
2023,10,25,쇼핑,지출,1419,260691
2022,1,29,식사,수입,5818,266509
2020,2,5,쇼핑,지출,8759,257750
2023,7,17,MT,수입,2906,260656
2023,7,20,쇼핑,수입,1446,262102
2021,9,11,체육대회,지출,6678,255424
2022,6,5,쇼핑,수입,7101,262525
2020,1,3,체육대회,지출,5847,256678
2020,4,29,식사,지출,3967,252711
2022,7,29,식사,지출,2321,250390
2020,5,12,MT,지출,6703,243687
2021,9,9,체육대회,수입,1078,244765
2020,10,25,쇼핑,수입,7507,252272
2022,8,8,여행,지출,9998,242274
2021,2,3,여행,수입,5845,248119
2022,9,27,MT,수입,8113,256232
2022,4,22,여행,지출,4371,251861
2022,7,16,쇼핑,수입,8370,260231
2020,1,21,쇼핑,수입,7128,267359
2023,3,1,여행,지출,6026,261333
2021,2,20,쇼핑,지출,9741,251592
2023,3,16,여행,수입,9284,260876
2022,9,17,쇼핑,수입,6064,266940
2020,10,22,쇼핑,지출,2600,264340
2023,1,15,여행,수입,9639,273979
2023,12,19,MT,지출,7913,266066
2021,4,17,체육대회,지출,6122,259944
2020,2,6,식사,수입,7742,267686
2020,1,21,식사,수입,3376,271062
2023,1,17,식사,지출,9744,261318
2020,4,22,MT,지출,6055,255263
2023,3,6,식사,수입,3459,258722
2021,6,1,쇼핑,지출,2034,256688
2022,10,25,체육대회,수입,3196,259884
2021,4,15,여행,수입,5552,265436
2023,2,14,체육대회,수입,1844,267280
2022,12,23,식사,수입,8868,276148
2023,6,9,체육대회,지출,2128,274020
2020,4,9,쇼핑,지출,8610,265410
2023,10,8,쇼핑,수입,6685,272095
2021,8,24,여행,지출,1358,270737
2022,11,27,MT,수입,1404,272141
2021,3,31,MT,수입,4961,277102
2021,3,19,체육대회,수입,3347,280449
2020,5,4,MT,수입,8018,288467
2022,11,24,체육대회,수입,2890,291357
2020,2,12,쇼핑,수입,7170,298527
2023,1,23,MT,지출,9978,288549
2022,3,10,식사,수입,4044,292593
2020,12,3,식사,수입,3134,295727
2023,8,11,체육대회,수입,8635,304362
2023,7,14,체육대회,수입,3437,307799
2021,7,31,여행,수입,2437,310236
2021,5,4,체육대회,지출,3884,306352
2023,10,1,식사,지출,3010,303342
2020,12,7,식사,지출,9951,293391
2020,11,15,체육대회,수입,2302,295693
2022,11,2,쇼핑,지출,3945,291748
2023,6,29,쇼핑,지출,5542,286206
2021,2,23,쇼핑,수입,7195,293401
2020,2,23,여행,지출,9996,283405
2023,9,22,식사,지출,2074,281331
2022,3,6,쇼핑,지출,3701,277630
2021,9,11,쇼핑,수입,9896,287526
2021,7,29,식사,지출,8510,279016
2022,11,25,쇼핑,지출,9137,269879
2022,3,15,여행,수입,4532,274411
2022,1,18,식사,지출,8579,265832
2022,2,14,체육대회,수입,1312,267144
2020,6,24,식사,지출,6155,260989
2022,5,8,식사,수입,1154,262143
2020,12,1,쇼핑,지출,4377,257766
2020,12,29,식사,지출,3350,254416
2023,7,21,체육대회,지출,2084,252332
2023,6,12,식사,수입,3700,256032
2021,6,22,체육대회,지출,9329,246703
2023,2,10,쇼핑,지출,1374,245329
2020,4,29,쇼핑,지출,9859,235470
2023,1,26,여행,수입,9598,245068
2022,6,16,체육대회,지출,4486,240582
2023,3,1,쇼핑,지출,9366,231216
2022,7,26,체육대회,수입,2347,233563
2022,8,6,식사,수입,8949,242512
2023,10,8,체육대회,수입,9288,251800
2020,12,17,MT,지출,6266,245534
2022,3,13,식사,지출,9157,236377
2023,9,12,여행,지출,4739,231638
2020,11,1,MT,지출,3595,228043
2020,10,2,쇼핑,지출,4579,223464
2020,2,23,쇼핑,수입,9712,233176
2022,9,22,체육대회,수입,9775,242951
2023,5,4,체육대회,지출,8756,234195
2020,2,28,여행,수입,1618,235813
2022,5,11,MT,지출,5552,230261
2021,11,12,식사,지출,4784,225477
2020,7,23,체육대회,수입,6490,231967
2022,6,17,체육대회,지출,2762,229205
2020,1,25,MT,지출,2214,226991
2023,8,14,여행,지출,3267,223724
2021,9,30,식사,수입,4799,228523
2020,7,18,여행,지출,7748,220775
2021,1,9,여행,지출,4208,216567
2022,9,27,체육대회,지출,3448,213119
2023,9,24,체육대회,지출,7630,205489
2023,6,8,체육대회,지출,9142,196347
2023,4,3,체육대회,지출,8444,187903
2023,2,4,쇼핑,수입,5636,193539
2022,10,11,쇼핑,지출,6139,187400
2022,7,3,쇼핑,수입,1336,188736
2020,12,18,체육대회,지출,3284,185452
2020,6,19,식사,수입,9644,195096
2021,3,4,여행,수입,2138,197234
2020,4,25,체육대회,지출,3982,193252
2023,4,29,MT,지출,4321,188931
2022,7,15,MT,수입,5489,194420
2020,11,4,쇼핑,지출,1029,193391
2023,3,22,여행,지출,2221,191170
2020,1,15,여행,수입,8091,199261
2021,10,9,쇼핑,지출,6424,192837
2020,7,27,식사,수입,4268,197105
2023,12,22,쇼핑,지출,4114,192991
2021,4,6,쇼핑,수입,2946,195937
2020,9,19,여행,지출,5768,190169
2021,1,29,체육대회,지출,9990,180179
2020,10,25,여행,수입,9314,189493
2021,3,29,쇼핑,지출,4987,184506
2021,5,23,쇼핑,지출,3895,180611
2022,11,29,쇼핑,지출,8304,172307
2021,6,8,여행,지출,5797,166510
2022,6,28,쇼핑,수입,2586,169096
2021,4,4,쇼핑,수입,4847,173943
2023,10,30,여행,수입,7913,181856
2023,4,29,체육대회,지출,5629,176227
2021,2,26,MT,지출,3783,172444
2020,4,25,쇼핑,지출,5181,167263
2022,8,24,체육대회,수입,7595,174858
2023,10,3,쇼핑,수입,9698,184556
2020,1,16,여행,수입,5997,190553
2022,1,26,체육대회,수입,7281,197834
2021,9,10,여행,지출,7479,190355
2023,12,1,MT,수입,7417,197772
2023,12,27,쇼핑,수입,1725,199497
2022,8,17,MT,수입,5055,204552
2021,5,26,식사,지출,1427,203125
2020,5,10,여행,지출,3997,199128
2020,7,27,체육대회,지출,2584,196544
2020,6,29,MT,지출,4741,191803
2023,12,31,여행,지출,8054,183749
2020,3,28,식사,지출,3789,179960
2020,6,3,식사,지출,6523,173437
2023,2,6,여행,지출,3492,169945
2020,10,7,쇼핑,수입,3127,173072
2023,8,6,MT,지출,1824,171248
2021,9,16,식사,지출,4951,166297
2023,6,12,MT,수입,6908,173205
2022,12,23,여행,지출,8997,164208
2023,1,15,쇼핑,수입,5927,170135
2021,12,20,쇼핑,수입,3562,173697
2021,2,1,MT,지출,8287,165410
2021,2,18,식사,지출,4238,161172
2023,3,31,식사,지출,5036,156136
2020,6,9,식사,수입,8076,164212
2022,1,14,식사,지출,5759,158453
2020,12,14,쇼핑,수입,4571,163024
2020,11,6,식사,수입,4573,167597
2022,11,21,식사,수입,7844,175441
2022,9,1,쇼핑,지출,8029,167412
2020,7,2,쇼핑,지출,5022,162390
2022,8,28,여행,수입,5610,168000
2022,10,2,MT,수입,8024,176024
2022,4,13,체육대회,수입,6392,182416
2023,1,9,식사,지출,6199,176217
2023,3,13,MT,수입,2410,178627
2021,8,13,쇼핑,지출,1609,177018
2023,8,26,식사,지출,9487,167531
2023,5,27,MT,수입,6077,173608
2021,5,26,여행,지출,7426,166182
2021,4,2,체육대회,지출,9542,156640
2020,7,19,여행,수입,5550,162190
2021,11,23,쇼핑,수입,6402,168592
2022,8,20,쇼핑,지출,6237,162355
2022,1,18,MT,수입,1749,164104
2022,10,14,식사,수입,5611,169715
2023,2,6,쇼핑,지출,8854,160861
2020,11,18,여행,수입,5306,166167
2023,11,27,체육대회,수입,7500,173667
2020,11,17,쇼핑,수입,1128,174795
2020,9,28,식사,수입,2937,177732
2020,9,8,여행,수입,1492,179224
2020,2,23,식사,수입,3663,182887
2023,10,27,MT,수입,1287,184174
2020,9,7,MT,지출,5368,178806
2020,1,10,체육대회,수입,5493,184299
2022,12,21,쇼핑,지출,4423,179876
2020,10,17,식사,수입,1467,181343
2020,7,2,체육대회,지출,1070,180273
2022,7,19,쇼핑,지출,8408,171865
2021,1,9,여행,수입,5037,176902
2020,12,17,쇼핑,지출,4545,172357
2021,3,29,여행,수입,1033,173390
2023,2,9,쇼핑,수입,3898,177288
2021,3,15,체육대회,수입,1709,178997
2021,8,12,쇼핑,수입,9136,188133
2020,11,19,식사,수입,1105,189238
2022,7,16,쇼핑,수입,8906,198144
2021,12,22,식사,지출,1579,196565
2023,5,19,여행,지출,2776,193789
2021,12,4,체육대회,지출,2520,191269
2023,1,15,체육대회,수입,9635,200904
2023,5,23,쇼핑,지출,1152,199752
2021,6,22,식사,지출,6232,193520
2020,2,18,체육대회,수입,2939,196459
2021,1,17,여행,지출,9371,187088
2022,12,8,식사,지출,2376,184712
2023,2,9,식사,수입,5591,190303
2023,3,9,MT,지출,8868,181435
2021,7,9,체육대회,지출,2898,178537
2021,9,28,식사,수입,5741,184278
2020,2,17,MT,수입,7628,191906
2022,1,14,여행,수입,6329,198235
2021,2,8,식사,수입,2374,200609
2023,12,7,쇼핑,수입,5007,205616
2022,5,9,MT,지출,4411,201205
2020,11,16,MT,지출,4776,196429
2022,10,8,식사,지출,6084,190345
2022,11,5,MT,지출,5634,184711
2020,10,6,여행,지출,1083,183628
2021,2,17,MT,수입,2140,185768
2022,2,12,여행,수입,5654,191422
2022,8,14,쇼핑,지출,6414,185008
2022,11,17,MT,수입,5398,190406
2021,4,6,체육대회,수입,5504,195910
2023,9,14,MT,지출,7186,188724
2020,10,13,여행,지출,8041,180683
2021,1,31,체육대회,지출,2124,178559
2023,11,27,쇼핑,수입,1417,179976
2021,10,16,여행,수입,7262,187238
2020,6,25,쇼핑,수입,1521,188759
2020,7,28,MT,수입,7862,196621
2020,4,3,체육대회,수입,9716,206337
2022,4,28,MT,수입,2382,208719
2022,9,23,여행,수입,9226,217945
2022,9,18,여행,수입,1022,218967
2023,7,22,체육대회,지출,6008,212959
2021,6,22,체육대회,지출,7732,205227
2023,2,9,체육대회,수입,4640,209867
2020,12,23,체육대회,지출,4839,205028
2020,2,27,체육대회,지출,9359,195669
2023,6,19,체육대회,수입,3608,199277
2020,8,10,쇼핑,수입,5686,204963
2023,2,9,쇼핑,수입,2651,207614
2023,2,21,쇼핑,수입,8791,216405
2023,7,30,체육대회,지출,4131,212274
2020,3,3,체육대회,지출,4055,208219
2023,8,13,쇼핑,지출,9314,198905
2023,8,31,여행,지출,5595,193310
2023,6,23,쇼핑,지출,3776,189534
2022,6,6,MT,수입,6625,196159
2021,8,26,쇼핑,지출,1854,194305
2022,4,22,쇼핑,수입,8585,202890
2021,5,31,여행,지출,6400,196490
2020,4,26,여행,지출,9608,186882
2021,5,26,체육대회,지출,5326,181556
2021,10,27,MT,수입,4574,186130
2021,2,6,식사,지출,1742,184388
2023,3,15,여행,지출,7137,177251
2023,7,31,여행,수입,4368,181619
2020,9,7,체육대회,수입,8903,190522
2021,1,3,체육대회,수입,3962,194484
2023,4,1,체육대회,지출,9259,185225
2022,8,21,쇼핑,수입,8391,193616
2021,6,20,MT,수입,3854,197470
2020,12,7,여행,수입,4197,201667
2020,12,24,쇼핑,수입,3351,205018
2023,6,29,체육대회,지출,3886,201132
2023,8,12,쇼핑,지출,3297,197835
2021,5,14,체육대회,지출,5203,192632
2021,11,29,쇼핑,수입,1153,193785
2022,7,21,MT,지출,5144,188641
2023,11,10,쇼핑,지출,1817,186824
2021,7,7,MT,지출,1671,185153
2021,3,29,MT,수입,3889,189042
2022,12,29,MT,수입,6513,195555
2023,3,5,여행,수입,4150,199705
2020,9,5,체육대회,수입,8872,208577
2020,9,9,체육대회,수입,2265,210842
2020,12,1,체육대회,수입,4673,215515
2020,11,18,체육대회,수입,6725,222240
2021,4,11,체육대회,지출,9618,212622
2023,1,11,체육대회,지출,1039,211583
2022,9,21,식사,지출,8272,203311
2021,3,18,여행,지출,6390,196921
2022,2,6,쇼핑,지출,5346,191575
2022,8,30,쇼핑,지출,6300,185275
2020,9,14,쇼핑,지출,3112,182163
2023,3,16,MT,지출,5528,176635
2023,11,20,체육대회,수입,9817,186452
2023,6,18,식사,지출,9880,176572
2021,8,5,여행,수입,5673,182245
2022,3,15,MT,지출,7762,174483
2023,1,22,여행,지출,3066,171417
2021,8,5,체육대회,지출,2178,169239
2020,12,18,체육대회,지출,9674,159565
2020,8,5,쇼핑,수입,4254,163819
2023,2,13,MT,수입,6641,170460
2021,10,20,쇼핑,수입,9237,179697
2023,12,26,MT,지출,2663,177034
2023,5,16,MT,지출,7664,169370
2022,1,22,MT,수입,3760,173130
2023,9,24,식사,지출,9222,163908
2021,4,18,MT,지출,7773,156135
2023,12,6,쇼핑,수입,8907,165042
2021,9,27,쇼핑,수입,7309,172351
2020,10,17,여행,지출,7638,164713
2020,8,11,MT,지출,6645,158068
2022,5,10,쇼핑,지출,6920,151148
2023,1,16,체육대회,수입,4874,156022
2022,9,25,MT,수입,7177,163199
2023,6,17,여행,지출,7980,155219
2022,12,13,MT,지출,6346,148873
2022,2,7,체육대회,수입,9054,157927
2023,12,22,여행,수입,8990,166917
2021,8,25,식사,지출,8421,158496
2023,11,20,쇼핑,수입,4670,163166
2022,9,12,여행,수입,2666,165832
2020,9,9,식사,지출,3807,162025
2023,2,27,식사,수입,2880,164905
2023,2,5,식사,지출,3590,161315
2021,10,7,체육대회,수입,6404,167719
2022,8,2,쇼핑,수입,4533,172252
2022,3,25,여행,지출,9176,163076
2021,12,2,체육대회,수입,5718,168794
2022,3,10,MT,지출,2731,166063
2020,10,27,체육대회,수입,2161,168224
2022,9,28,식사,수입,7760,175984
2021,4,2,MT,지출,6358,169626
2023,11,3,MT,수입,1716,171342
2022,5,8,쇼핑,수입,3009,174351
2020,9,15,쇼핑,수입,8389,182740
2020,3,23,식사,수입,8857,191597
2022,10,1,MT,수입,5695,197292
2020,7,1,여행,수입,3194,200486
2021,5,1,식사,지출,5264,195222
2022,11,14,식사,지출,8156,187066
2022,5,15,식사,지출,7516,179550
2020,10,12,MT,수입,5495,185045
2023,11,3,쇼핑,지출,1002,184043
2023,6,23,여행,지출,8581,175462
2021,6,2,여행,지출,4664,170798
2022,2,21,쇼핑,지출,8403,162395
2022,4,1,체육대회,지출,5630,156765
2020,10,19,MT,지출,5400,151365
2021,8,26,쇼핑,수입,2475,153840
2023,6,6,체육대회,지출,9791,144049
2022,8,17,여행,지출,7983,136066
2020,7,13,여행,지출,2170,133896
2023,6,17,쇼핑,지출,4727,129169
2022,2,17,여행,수입,9506,138675
2020,10,28,여행,수입,9436,148111
2023,8,18,체육대회,수입,5021,153132
2020,12,14,MT,지출,4199,148933
2021,8,28,체육대회,지출,9662,139271
2020,9,10,MT,수입,2242,141513
2020,3,11,쇼핑,수입,6230,147743
2023,9,2,MT,지출,7402,140341
2020,10,31,여행,수입,1221,141562
2020,9,22,MT,수입,5308,146870
2020,8,27,MT,지출,8124,138746
2020,9,10,체육대회,수입,3411,142157
2023,1,4,체육대회,지출,8157,134000
2022,6,13,식사,지출,3043,130957
2021,9,11,쇼핑,지출,8838,122119
2020,7,21,쇼핑,수입,2344,124463
2022,7,1,식사,지출,2301,122162
2020,11,15,여행,수입,8537,130699
2021,6,10,쇼핑,수입,9933,140632
2023,10,13,식사,수입,9571,150203
2022,8,16,MT,지출,8015,142188
2020,10,10,여행,지출,1081,141107
2023,5,19,쇼핑,지출,1662,139445
2020,3,14,식사,수입,9651,149096
2023,6,12,쇼핑,지출,8076,141020
2020,11,26,MT,수입,9731,150751
2023,8,12,MT,지출,1505,149246
2023,4,29,MT,수입,2178,151424
2021,4,9,쇼핑,지출,4146,147278
2023,4,27,여행,지출,3621,143657
2022,10,8,MT,수입,4397,148054
2020,1,15,체육대회,지출,8045,140009
2020,4,29,식사,수입,1730,141739
2020,12,2,쇼핑,수입,2091,143830
2020,1,16,MT,지출,4207,139623
2021,4,17,여행,지출,5733,133890
2021,12,24,쇼핑,지출,2186,131704
2022,5,21,MT,지출,8768,122936
2021,9,17,식사,지출,9285,113651
2022,7,24,쇼핑,수입,2573,116224
2020,6,17,MT,수입,2723,118947
2021,4,3,식사,수입,2188,121135
2023,8,8,식사,지출,8251,112884
2020,2,7,여행,수입,1718,114602
2023,7,14,여행,수입,7624,122226
2021,6,28,MT,수입,3922,126148
2023,12,5,쇼핑,수입,5497,131645
2021,4,17,쇼핑,지출,2300,129345
2021,2,28,식사,수입,4480,133825
2020,7,3,MT,지출,8299,125526
2022,6,26,체육대회,수입,6751,132277
2020,1,24,여행,수입,6592,138869
2021,11,9,체육대회,수입,1146,140015
2020,2,10,여행,수입,2548,142563
2021,8,12,쇼핑,지출,2957,139606
2020,1,28,식사,수입,8206,147812
2022,5,2,쇼핑,수입,3217,151029
2023,11,19,식사,지출,3320,147709
2021,4,5,여행,지출,2146,145563
2023,6,6,쇼핑,지출,3895,141668
2021,12,26,여행,수입,1956,143624
2021,8,30,식사,지출,1728,141896
2020,5,5,MT,수입,3465,145361
2020,11,2,MT,지출,7544,137817
2022,5,18,체육대회,수입,8038,145855
2022,11,17,체육대회,지출,5255,140600
2021,2,12,MT,지출,6802,133798
2020,5,10,여행,지출,5027,128771
2022,2,26,쇼핑,수입,8525,137296
2021,5,15,식사,지출,9033,128263
2020,10,22,체육대회,지출,4284,123979
2023,11,20,체육대회,수입,8499,132478
2023,7,17,체육대회,지출,2967,129511
2023,6,6,쇼핑,지출,6517,122994
2022,6,25,쇼핑,지출,9316,113678
2023,6,17,MT,수입,7438,121116
2021,6,8,체육대회,수입,8339,129455
2023,12,22,체육대회,수입,9836,139291
2020,8,23,체육대회,지출,1754,137537
2021,10,14,체육대회,수입,2370,139907
2022,2,5,쇼핑,수입,2116,142023
2023,5,26,식사,지출,6442,135581
2022,6,6,쇼핑,수입,8681,144262
2021,7,24,식사,지출,5760,138502
2020,1,12,체육대회,지출,7896,130606
2022,11,13,여행,수입,2433,133039
2022,6,20,쇼핑,지출,4631,128408
2021,4,21,MT,지출,5514,122894
2023,9,26,식사,지출,5332,117562
2023,8,27,쇼핑,수입,1080,118642
2021,2,2,쇼핑,수입,4941,123583
2023,7,8,쇼핑,지출,3931,119652
2023,6,22,식사,지출,4668,114984
2020,7,12,여행,수입,7894,122878
2021,7,8,MT,지출,7723,115155
2023,2,9,쇼핑,지출,9476,105679
2022,5,25,체육대회,수입,9432,115111
2022,2,4,체육대회,지출,9919,105192
2023,2,17,식사,수입,8651,113843
2021,4,23,MT,수입,8716,122559
2020,10,1,MT,수입,7758,130317
2020,4,3,MT,지출,6014,124303
2021,1,1,여행,지출,1612,122691
2022,12,10,MT,수입,3701,126392
2020,1,7,MT,수입,5430,131822
2022,9,19,식사,수입,6620,138442
2020,3,14,MT,수입,6753,145195
2021,7,22,쇼핑,수입,4201,149396
2022,5,31,식사,지출,5770,143626
2022,9,15,체육대회,지출,1346,142280
2023,12,13,체육대회,지출,5478,136802
2022,12,26,쇼핑,지출,9493,127309
2020,9,29,쇼핑,지출,1502,125807
2021,6,19,MT,지출,8676,117131
2020,7,18,식사,수입,4231,121362
2023,8,11,MT,지출,8520,112842
2020,9,12,식사,수입,8826,121668
2021,1,6,체육대회,지출,6185,115483
2021,1,8,쇼핑,지출,5143,110340
2020,5,11,식사,수입,6521,116861
2021,2,11,체육대회,지출,2992,113869
2023,11,14,체육대회,수입,3037,116906
2022,5,30,쇼핑,수입,3488,120394
2023,8,7,식사,지출,9221,111173
2023,4,27,쇼핑,지출,1911,109262
2021,5,8,식사,수입,3968,113230
2022,10,10,체육대회,지출,9491,103739
2022,8,6,MT,지출,6008,97731
2020,11,29,여행,수입,2847,100578
2020,4,20,MT,수입,2550,103128
2023,3,12,체육대회,수입,1449,104577
2022,2,10,식사,지출,2078,102499
2023,12,29,체육대회,수입,2813,105312
2021,8,20,체육대회,지출,9892,95420
2021,10,12,쇼핑,지출,5026,90394
2021,2,24,여행,지출,1280,89114
2022,1,10,식사,지출,7823,81291
2021,2,5,체육대회,지출,7546,73745
2021,7,24,여행,지출,1038,72707
2022,4,27,체육대회,지출,5469,67238
2021,6,23,쇼핑,지출,7348,59890
2023,8,8,식사,수입,2407,62297
2020,9,10,식사,지출,7350,54947
2021,5,2,체육대회,수입,4526,59473
2023,12,23,여행,지출,1890,57583
2022,12,2,MT,지출,9451,48132
2023,6,29,쇼핑,수입,7115,55247
2023,5,18,여행,지출,1258,53989
2022,1,25,식사,수입,7005,60994
2021,8,26,여행,지출,5584,55410
2021,5,9,여행,지출,2450,52960
2023,2,2,쇼핑,지출,1637,51323
2021,3,27,식사,지출,8262,43061
2023,9,16,식사,수입,8614,51675
2020,11,27,쇼핑,수입,2650,54325
2021,5,2,식사,지출,9577,44748
2022,5,25,체육대회,지출,6672,38076
2021,6,9,쇼핑,지출,9558,28518
2021,7,5,여행,지출,6528,21990
2021,10,3,체육대회,수입,2017,24007
2021,3,29,MT,수입,5054,29061
2020,5,2,쇼핑,수입,6301,35362
2023,9,11,식사,지출,9957,25405
2020,5,23,식사,지출,8140,17265
2022,2,7,체육대회,지출,7237,10028
2022,3,15,쇼핑,수입,1391,11419
2022,12,19,체육대회,지출,4298,7121
2021,12,27,체육대회,수입,4925,12046
2023,12,7,MT,수입,3053,15099
2020,4,26,MT,지출,8389,6710
2020,5,10,체육대회,수입,8439,15149
2021,3,18,MT,수입,7714,22863
2023,6,3,쇼핑,지출,2150,20713
2021,11,19,체육대회,수입,5044,25757
2020,6,5,체육대회,지출,4022,21735
2021,3,6,식사,수입,9906,31641
2022,10,28,체육대회,지출,6409,25232
2021,9,19,여행,수입,5687,30919
2021,6,20,여행,수입,5154,36073
2023,5,15,여행,지출,5040,31033
2021,12,8,MT,수입,6194,37227
2020,10,20,여행,수입,1764,38991
2021,1,18,식사,수입,1348,40339
2021,2,4,여행,수입,5089,45428
2022,1,30,여행,수입,9239,54667
2023,7,6,MT,지출,8575,46092
2022,6,6,MT,지출,8390,37702
2023,11,23,여행,수입,2835,40537
2022,5,18,식사,수입,3295,43832
2020,12,25,식사,지출,9973,33859
2022,11,4,식사,지출,6653,27206
2021,2,16,식사,지출,1570,25636
2020,4,3,체육대회,지출,7352,18284
2021,7,29,체육대회,수입,7055,25339
2023,10,21,식사,수입,4120,29459
2022,4,21,식사,수입,7586,37045
2021,10,16,체육대회,지출,2601,34444
2020,9,20,식사,수입,5627,40071
2023,10,28,MT,지출,4707,35364
2022,3,22,쇼핑,수입,8308,43672
2023,11,30,MT,지출,8069,35603
2020,6,20,쇼핑,수입,5312,40915
2023,10,20,쇼핑,수입,2931,43846
2023,1,13,MT,수입,7219,51065
2023,5,10,체육대회,수입,2262,53327
2023,1,10,쇼핑,수입,6208,59535
2022,4,10,쇼핑,수입,3737,63272
2023,2,20,식사,수입,3803,67075
2023,12,13,식사,수입,3831,70906
2020,2,14,여행,지출,3061,67845
2021,9,14,여행,수입,6132,73977
2023,2,19,체육대회,수입,6949,80926
2022,11,24,식사,수입,8862,89788
2023,3,7,쇼핑,수입,6518,96306
2021,11,10,식사,수입,7196,103502
2022,10,21,MT,지출,8777,94725
2021,3,12,여행,지출,4380,90345
2022,1,12,여행,수입,6464,96809
2021,9,19,체육대회,수입,6145,102954
2020,8,27,쇼핑,지출,6709,96245
2023,12,24,쇼핑,지출,2798,93447
2023,12,12,여행,지출,4122,89325
2022,12,26,식사,지출,7351,81974
2023,4,23,체육대회,지출,2580,79394
2023,4,30,체육대회,지출,5713,73681
2023,2,1,여행,지출,5011,68670
2023,8,15,식사,지출,3479,65191
2023,5,1,체육대회,수입,2616,67807
2021,5,24,식사,수입,6614,74421
2022,10,7,MT,지출,6016,68405
2022,6,6,체육대회,수입,6519,74924
2022,3,7,여행,지출,6536,68388
2021,1,7,쇼핑,수입,4983,73371
2023,1,28,쇼핑,지출,6356,67015
2020,6,16,MT,지출,5730,61285
2020,11,9,식사,지출,9483,51802
2022,10,16,쇼핑,지출,4130,47672
2022,2,13,MT,수입,9902,57574
2021,2,17,여행,수입,4344,61918
2021,8,1,여행,수입,1390,63308
2023,2,21,여행,수입,7093,70401
2021,8,18,MT,지출,9011,61390
2023,1,1,여행,지출,6234,55156
2022,5,18,여행,수입,5001,60157
2022,4,30,MT,수입,5013,65170
2022,12,18,쇼핑,지출,2971,62199
2021,11,11,MT,수입,7624,69823
2020,4,25,체육대회,지출,9411,60412
2022,7,27,여행,수입,8378,68790
2020,1,1,체육대회,수입,8041,76831
2021,3,13,체육대회,지출,4724,72107
2023,8,7,쇼핑,지출,5787,66320
2023,10,7,체육대회,지출,9398,56922
2021,3,10,체육대회,수입,4681,61603
2023,8,14,식사,수입,9982,71585
2020,1,16,식사,지출,6809,64776
2020,6,13,여행,지출,5621,59155
2023,1,16,MT,수입,4280,63435
2023,1,19,MT,지출,7916,55519
2020,9,25,식사,수입,3866,59385
2021,6,26,체육대회,수입,7664,67049
2022,8,31,MT,지출,5268,61781
2023,5,13,쇼핑,수입,6283,68064
2023,7,2,식사,수입,5917,73981
2022,11,29,체육대회,수입,2999,76980
2023,10,11,쇼핑,수입,3101,80081
2022,4,16,쇼핑,지출,5484,74597
2021,5,17,식사,지출,9076,65521
2021,2,11,MT,수입,6519,72040
2021,9,12,식사,지출,4424,67616
2023,4,28,식사,지출,3987,63629
2021,11,5,MT,수입,3860,67489
2023,10,7,여행,지출,9264,58225
2021,3,23,식사,지출,7666,50559
2021,6,16,식사,지출,6756,43803
2021,9,4,MT,지출,6926,36877
2023,7,18,체육대회,수입,5807,42684
2023,3,10,여행,지출,5041,37643
2020,5,13,MT,수입,8475,46118
2021,5,23,체육대회,지출,7912,38206
2023,6,1,여행,지출,5861,32345
2023,7,31,식사,지출,6863,25482
2020,9,2,여행,지출,9812,15670
2023,6,29,쇼핑,지출,5090,10580
2020,10,15,쇼핑,수입,3995,14575
2023,9,1,여행,수입,4005,18580
2023,11,17,MT,지출,8206,10374
2020,4,26,식사,수입,8220,18594
2021,12,6,MT,지출,2890,15704
2022,12,28,식사,지출,7841,7863
2023,11,26,체육대회,수입,4972,12835
2023,7,25,쇼핑,지출,9687,3148
2021,9,25,체육대회,수입,3895,7043
2022,9,28,MT,지출,9928,-2885
2023,4,11,MT,지출,2275,-5160
2022,2,19,여행,지출,7111,-12271
2021,12,7,체육대회,지출,2664,-14935
2021,7,4,여행,지출,7997,-22932
2023,3,22,여행,지출,9407,-32339
2022,9,29,식사,지출,3988,-36327
2022,7,29,식사,수입,3253,-33074
2020,3,29,MT,수입,3283,-29791
2023,8,17,식사,지출,3833,-33624
2021,4,3,MT,지출,4316,-37940
2022,5,24,쇼핑,수입,9497,-28443
2023,5,23,식사,수입,9393,-19050
2021,10,13,여행,수입,7357,-11693
2020,7,14,여행,수입,3146,-8547
2020,7,7,여행,수입,6865,-1682
2021,6,29,쇼핑,지출,6918,-8600
2022,11,17,여행,지출,5406,-14006
2022,9,12,쇼핑,수입,4227,-9779
2021,7,1,여행,지출,3579,-13358
2021,5,19,여행,지출,6321,-19679
2021,12,30,MT,지출,3702,-23381
2021,5,8,여행,지출,1124,-24505
2021,7,11,체육대회,수입,1548,-22957
2021,4,29,체육대회,지출,8938,-31895
2020,6,23,여행,지출,5347,-37242
2021,10,17,여행,지출,1611,-38853
2022,4,27,체육대회,수입,8664,-30189
2020,6,19,체육대회,지출,8272,-38461
2021,9,7,식사,지출,5313,-43774
2021,1,2,체육대회,지출,5971,-49745
2021,10,7,쇼핑,수입,3045,-46700
2022,8,16,체육대회,수입,8079,-38621
2023,4,15,쇼핑,지출,9132,-47753
2021,11,29,여행,수입,5195,-42558
2021,11,13,여행,수입,6621,-35937
2020,12,9,MT,지출,4043,-39980
2023,7,17,식사,지출,7954,-47934
2021,3,10,쇼핑,지출,9230,-57164
2023,9,25,여행,지출,2404,-59568
2020,8,29,식사,수입,5632,-53936
2022,3,11,식사,지출,3443,-57379
2021,2,22,여행,수입,9372,-48007
2020,8,21,체육대회,수입,9174,-38833
2020,5,20,여행,수입,7723,-31110
2021,7,25,쇼핑,지출,5722,-36832
2020,7,24,여행,지출,5715,-42547
2020,12,21,여행,수입,5102,-37445
2022,2,10,쇼핑,수입,4647,-32798
2023,3,21,쇼핑,수입,5903,-26895
2021,1,7,식사,지출,9435,-36330
2021,5,9,MT,수입,2462,-33868
2022,11,23,식사,수입,8860,-25008
2022,1,29,체육대회,지출,4435,-29443
2020,1,5,쇼핑,지출,1869,-31312
2023,10,7,체육대회,수입,2389,-28923
2020,9,11,체육대회,지출,8698,-37621
2020,10,25,여행,수입,3242,-34379
2020,2,10,MT,지출,5145,-39524
2021,10,4,MT,지출,4635,-44159
2022,10,3,MT,지출,4869,-49028
2023,1,30,MT,수입,9128,-39900
2020,1,19,체육대회,수입,8169,-31731
2020,10,21,MT,지출,3360,-35091
2020,4,11,식사,지출,8060,-43151
2021,12,17,식사,지출,7184,-50335
2023,2,18,체육대회,지출,1359,-51694
2020,11,16,MT,수입,4920,-46774
2020,9,21,여행,수입,3379,-43395
2022,10,21,식사,지출,6287,-49682
2020,5,8,여행,수입,7871,-41811
2021,3,12,체육대회,수입,2971,-38840
2022,10,7,여행,수입,8914,-29926
2022,10,4,체육대회,수입,8793,-21133
2023,3,9,쇼핑,지출,3314,-24447
2023,9,15,MT,수입,6624,-17823
2022,6,15,여행,수입,4822,-13001
2023,3,10,식사,수입,5486,-7515
2020,8,24,여행,지출,9250,-16765
2023,11,23,식사,지출,8194,-24959
2021,3,31,쇼핑,지출,7919,-32878
2020,4,29,쇼핑,수입,8938,-23940
2021,3,15,여행,지출,9648,-33588
2020,3,6,쇼핑,지출,1468,-35056
2022,5,24,식사,수입,9544,-25512
2020,11,25,쇼핑,지출,8332,-33844
2021,4,14,체육대회,지출,2941,-36785
2023,12,2,여행,지출,9533,-46318
2022,1,5,여행,수입,5965,-40353
2020,3,5,식사,수입,1784,-38569
2021,3,21,식사,지출,3776,-42345
2022,7,20,여행,수입,5015,-37330
2022,3,10,여행,지출,3772,-41102
2022,2,6,체육대회,수입,6383,-34719
2023,2,15,식사,수입,3676,-31043
2020,10,31,체육대회,수입,1308,-29735
2021,4,2,MT,지출,8319,-38054
2022,8,21,쇼핑,수입,8411,-29643
2020,2,20,식사,지출,5381,-35024
2021,11,10,MT,지출,8508,-43532
2022,11,19,여행,수입,7645,-35887
2023,10,4,여행,수입,5853,-30034
2021,9,4,여행,수입,2855,-27179
2021,8,1,쇼핑,지출,8438,-35617
2021,10,7,체육대회,지출,5227,-40844
2022,2,19,쇼핑,수입,2622,-38222
2021,10,9,여행,수입,4864,-33358
2023,2,27,체육대회,수입,5850,-27508
2023,8,21,MT,지출,5541,-33049
2021,1,26,식사,지출,6706,-39755
2022,4,22,쇼핑,지출,6713,-46468
2023,11,27,체육대회,수입,9723,-36745
2023,10,18,식사,수입,9690,-27055
2022,3,8,식사,지출,1481,-28536
2022,8,7,식사,지출,7500,-36036
2023,3,14,MT,수입,6031,-30005
2021,6,24,여행,수입,1812,-28193
2021,4,30,MT,수입,1693,-26500
2023,4,5,MT,수입,9952,-16548
2021,5,13,MT,수입,7198,-9350
2022,12,2,MT,수입,7691,-1659
2020,8,9,쇼핑,지출,3673,-5332
2021,5,24,쇼핑,수입,4076,-1256
2023,12,18,체육대회,수입,7974,6718
2023,5,21,체육대회,수입,6436,13154
2020,11,6,MT,지출,2921,10233
2022,6,10,쇼핑,지출,3483,6750
2020,4,21,식사,수입,8148,14898
2020,2,26,식사,지출,2789,12109
2023,8,29,식사,수입,7234,19343
2022,2,27,쇼핑,수입,6714,26057
2023,11,23,쇼핑,지출,9770,16287
2022,8,14,MT,지출,1905,14382
2020,6,8,MT,지출,1528,12854
2022,7,1,식사,수입,4974,17828
2021,5,26,MT,지출,2705,15123
2022,11,26,여행,지출,8787,6336
2020,12,23,MT,지출,6595,-259
2020,6,23,식사,지출,4792,-5051
2020,2,22,여행,지출,6839,-11890
2021,9,1,여행,지출,9183,-21073
2020,5,24,쇼핑,지출,3613,-24686
2023,8,29,체육대회,수입,7813,-16873
2023,4,17,MT,수입,4180,-12693
2022,11,23,식사,지출,6069,-18762
2021,5,26,여행,수입,9470,-9292
2021,9,16,여행,지출,4622,-13914
2020,12,28,여행,수입,5661,-8253
2022,2,9,MT,수입,1044,-7209
2021,7,23,체육대회,수입,9125,1916
2020,1,14,여행,수입,8558,10474
2020,1,8,체육대회,수입,3988,14462
2021,8,5,식사,수입,5348,19810
2021,11,20,MT,지출,2345,17465
2022,3,14,식사,지출,5842,11623
2021,2,7,체육대회,수입,9993,21616
2021,12,1,MT,수입,5902,27518
2021,5,20,식사,지출,1361,26157
2022,9,8,체육대회,수입,1129,27286
2021,2,19,식사,지출,2826,24460
2022,1,9,여행,수입,2583,27043
2021,3,17,MT,지출,2556,24487
2020,3,22,쇼핑,지출,5046,19441
2023,8,5,MT,수입,2506,21947
2021,11,14,체육대회,수입,4511,26458
2022,12,15,쇼핑,수입,6746,33204
2023,2,22,여행,수입,1165,34369
2021,5,11,여행,지출,5280,29089
2021,1,13,체육대회,지출,9256,19833
2021,5,17,체육대회,수입,5243,25076
2021,6,2,식사,수입,1552,26628
2022,10,24,식사,수입,7329,33957
2021,10,24,체육대회,수입,5200,39157
2023,8,14,MT,지출,8503,30654
2023,12,20,여행,수입,9113,39767
2021,2,8,여행,수입,2036,41803
2021,4,18,체육대회,지출,9052,32751
2023,6,1,쇼핑,수입,2458,35209
2020,3,22,MT,수입,9769,44978
2020,7,4,쇼핑,수입,4093,49071
2020,3,18,MT,지출,7577,41494
2021,5,14,여행,수입,5631,47125
2023,11,16,체육대회,수입,3812,50937
2020,7,30,체육대회,지출,9288,41649
2021,11,20,MT,지출,6045,35604
2021,4,15,MT,지출,3238,32366
2022,10,21,쇼핑,수입,6715,39081
2022,8,1,여행,수입,2141,41222
2023,8,20,쇼핑,수입,9612,50834
2020,11,18,식사,수입,5511,56345
2023,11,18,식사,수입,9253,65598
2022,11,16,MT,지출,2810,62788
2021,1,23,쇼핑,지출,5483,57305
2022,5,7,여행,지출,5483,51822
2020,11,29,쇼핑,지출,5051,46771
2022,5,11,여행,수입,9092,55863
2021,4,23,여행,수입,2029,57892
2022,9,1,MT,지출,2299,55593
2020,5,20,체육대회,수입,4783,60376
2023,6,23,식사,수입,9297,69673
2022,8,10,쇼핑,지출,1673,68000
2020,10,9,쇼핑,지출,5288,62712
2021,4,23,여행,수입,5200,67912
2021,11,23,여행,수입,7257,75169
2021,9,23,체육대회,지출,3685,71484
2021,11,3,식사,지출,6952,64532
2023,6,23,체육대회,지출,1322,63210
2023,9,12,MT,지출,8016,55194
2020,10,31,여행,지출,3306,51888
2021,12,31,식사,지출,6460,45428
2021,11,14,쇼핑,지출,4825,40603
2021,12,31,식사,지출,5406,35197
2023,10,31,여행,지출,1296,33901
2023,12,17,쇼핑,지출,2505,31396
2020,8,1,쇼핑,지출,3131,28265
2020,8,4,식사,수입,9322,37587
2021,7,13,MT,지출,5807,31780
2022,10,2,체육대회,지출,5104,26676
2022,3,11,쇼핑,지출,3889,22787
2020,7,2,여행,지출,9521,13266
2021,4,20,쇼핑,지출,7767,5499
2023,9,30,여행,지출,7569,-2070
2023,7,17,MT,지출,3112,-5182
2022,7,17,MT,수입,8340,3158
2023,1,3,쇼핑,수입,1598,4756
2021,11,8,쇼핑,수입,4414,9170
2020,8,8,쇼핑,수입,5487,14657
2021,11,2,쇼핑,지출,4309,10348
2023,8,18,식사,수입,3991,14339
2020,4,26,여행,수입,7662,22001
2020,4,28,쇼핑,수입,7724,29725
2023,3,25,여행,수입,8669,38394
2023,9,27,쇼핑,지출,8573,29821
2023,2,15,식사,수입,4705,34526
2020,3,10,식사,수입,5517,40043
2023,11,1,쇼핑,지출,6354,33689
2021,3,29,체육대회,지출,1880,31809
2021,9,26,여행,지출,8573,23236
2022,12,23,체육대회,지출,6643,16593
2020,6,28,쇼핑,수입,2303,18896
2023,6,15,쇼핑,지출,7633,11263
2021,9,8,체육대회,수입,4700,15963
2021,4,5,쇼핑,수입,1525,17488
2021,4,1,여행,수입,9871,27359
2022,10,26,MT,수입,5120,32479
2022,3,19,여행,수입,6461,38940
2021,3,30,MT,수입,8867,47807
2022,10,16,체육대회,수입,6592,54399
2020,2,27,MT,지출,5939,48460
2020,11,21,여행,수입,4608,53068
2023,10,14,체육대회,수입,5829,58897
2020,5,3,체육대회,수입,1957,60854
2023,5,2,여행,수입,5538,66392
2022,9,13,체육대회,지출,8987,57405
2022,12,23,MT,지출,4584,52821
2022,4,15,체육대회,수입,2550,55371
2021,10,24,여행,수입,6506,61877
2022,6,4,쇼핑,지출,4758,57119
2023,4,17,쇼핑,지출,5831,51288
2022,1,3,MT,수입,2819,54107
2022,11,4,식사,수입,1476,55583
2021,2,11,식사,수입,9151,64734
2021,11,30,식사,지출,4999,59735
2021,5,20,체육대회,지출,1496,58239
2020,10,2,여행,지출,9141,49098
2020,11,19,MT,지출,3220,45878
2022,10,5,식사,수입,3449,49327
2023,1,9,여행,수입,5414,54741
2020,8,31,쇼핑,지출,6670,48071
2023,12,20,식사,지출,1479,46592
2023,3,18,체육대회,지출,4480,42112
2021,9,26,쇼핑,수입,3430,45542
2023,10,15,여행,수입,4612,50154
2023,10,8,체육대회,수입,8358,58512
2020,10,30,여행,지출,9107,49405
2020,1,4,체육대회,지출,2986,46419
2022,7,15,여행,수입,9236,55655
2021,5,19,식사,수입,4712,60367
2021,5,29,쇼핑,지출,7728,52639
2023,12,11,쇼핑,수입,2712,55351
2023,6,13,쇼핑,지출,9653,45698
2023,6,29,MT,지출,1147,44551
2020,2,20,체육대회,지출,2324,42227
2021,5,31,체육대회,수입,5118,47345
2022,5,2,식사,지출,1117,46228
2021,11,8,쇼핑,수입,8532,54760
2022,8,8,여행,지출,2285,52475
2023,9,1,체육대회,수입,1721,54196
2021,6,29,여행,지출,4509,49687
2022,12,29,체육대회,수입,8315,58002
2023,12,18,쇼핑,지출,2735,55267
2020,12,27,식사,수입,6144,61411
2023,10,14,식사,수입,5990,67401
2020,9,27,식사,지출,7162,60239
2022,11,1,식사,지출,1928,58311
2020,4,28,MT,수입,3481,61792
2023,9,19,MT,수입,8238,70030
2023,11,7,MT,지출,1274,68756
2021,12,6,식사,지출,8020,60736
2023,10,1,MT,지출,1942,58794
2023,3,18,체육대회,지출,1401,57393
2020,4,13,체육대회,수입,3537,60930
2021,10,2,쇼핑,수입,4699,65629
2023,11,20,MT,지출,6683,58946
2020,10,4,MT,지출,3951,54995
2021,11,1,여행,수입,8924,63919
2022,2,28,체육대회,수입,1933,65852
2021,7,12,체육대회,수입,7321,73173
2023,10,18,MT,수입,1726,74899
2022,1,29,체육대회,수입,9275,84174
2021,5,19,MT,지출,2213,81961
2022,11,11,MT,지출,9209,72752
2021,10,17,식사,수입,9038,81790
2022,2,18,체육대회,지출,2443,79347
2023,12,13,MT,지출,9481,69866
2021,1,14,식사,수입,5532,75398
2023,12,31,식사,수입,9728,85126
2022,8,11,식사,지출,5437,79689
2020,9,26,쇼핑,지출,2113,77576
2020,8,29,쇼핑,지출,5921,71655
2022,11,10,쇼핑,지출,1404,70251
2020,11,7,MT,지출,6925,63326
2021,2,6,식사,수입,9522,72848
2023,12,7,쇼핑,수입,9490,82338
2022,7,17,식사,지출,3468,78870
2023,5,19,MT,수입,5331,84201
2023,7,24,쇼핑,지출,8920,75281
2022,9,26,쇼핑,수입,6355,81636
2020,6,26,쇼핑,수입,3425,85061
2020,7,24,식사,수입,9497,94558
2023,5,21,식사,지출,2171,92387
2023,2,14,여행,지출,6895,85492
2020,9,17,여행,수입,3521,89013
2023,7,12,쇼핑,지출,7638,81375
2021,12,15,식사,지출,3732,77643
2021,11,18,체육대회,지출,8814,68829
2023,4,29,체육대회,수입,2410,71239
2022,11,27,MT,수입,2395,73634
2023,2,21,식사,지출,4366,69268
2021,3,20,MT,수입,5103,74371
2020,5,29,MT,수입,5947,80318
2020,1,25,여행,수입,6895,87213
2021,2,14,체육대회,지출,3386,83827
2021,3,30,여행,수입,8918,92745
2020,7,5,여행,수입,4785,97530
2020,12,11,식사,수입,8587,106117
2021,4,30,여행,수입,9271,115388
2023,5,13,여행,수입,4175,119563
2022,10,31,쇼핑,수입,7402,126965
2022,7,19,쇼핑,수입,8205,135170
2023,2,13,쇼핑,지출,9411,125759
2020,5,30,여행,수입,8654,134413
2021,8,6,MT,지출,8538,125875
2020,3,24,식사,지출,7988,117887
2022,4,10,여행,지출,4202,113685
2022,3,1,여행,지출,3060,110625
2020,12,23,여행,수입,3839,114464
2021,3,31,MT,수입,2078,116542
2023,10,22,체육대회,지출,9841,106701
2020,7,17,쇼핑,수입,9808,116509
2023,1,3,식사,수입,4473,120982
2023,2,7,쇼핑,지출,9608,111374
2023,7,16,여행,수입,2749,114123
2022,3,30,쇼핑,지출,4382,109741
2020,11,1,체육대회,지출,4160,105581
2023,12,3,식사,수입,2322,107903
2021,12,31,식사,수입,7949,115852
2020,6,8,식사,수입,4130,119982
2022,8,5,MT,지출,5940,114042
2021,4,12,MT,지출,4033,110009
2021,11,10,식사,지출,2837,107172
2023,9,7,식사,수입,9770,116942
2023,8,16,식사,지출,9455,107487
2020,4,9,쇼핑,지출,4267,103220
2021,9,16,식사,수입,6242,109462
2023,7,12,쇼핑,지출,3632,105830
2022,3,6,여행,수입,2362,108192
2022,8,12,MT,수입,8079,116271
2020,7,16,여행,지출,1187,115084
2023,4,27,MT,지출,3427,111657
2022,12,7,식사,수입,7988,119645
2021,5,6,쇼핑,수입,1860,121505
2023,12,31,여행,수입,2972,124477
2021,6,18,식사,지출,4265,120212
2023,10,19,식사,수입,8500,128712
2022,3,4,쇼핑,수입,2147,130859
2022,5,29,여행,지출,7726,123133
2021,3,9,식사,수입,3368,126501
2021,2,15,체육대회,수입,4096,130597
2023,7,11,식사,지출,9283,121314
2020,8,25,쇼핑,지출,8336,112978
2022,5,7,쇼핑,지출,1118,111860
2023,12,15,체육대회,수입,3087,114947
2023,1,10,쇼핑,지출,9109,105838
2020,3,19,식사,수입,6195,112033
2022,7,16,MT,수입,7136,119169
2023,6,28,체육대회,지출,9639,109530
2022,3,27,쇼핑,수입,1651,111181
2021,2,24,여행,수입,9410,120591
2023,2,8,식사,지출,9587,111004
2023,7,6,MT,지출,6900,104104
2023,4,22,MT,지출,6723,97381
2020,11,7,쇼핑,수입,1779,99160
2020,3,23,MT,지출,9902,89258
2022,11,8,쇼핑,수입,5654,94912
2023,9,23,식사,지출,6481,88431
2023,8,10,쇼핑,수입,2494,90925
2021,3,7,MT,지출,6735,84190
2023,4,21,체육대회,수입,3252,87442
2022,9,24,MT,지출,9056,78386
2023,9,8,여행,지출,4948,73438
2020,12,7,MT,수입,5532,78970
2021,12,8,여행,수입,5352,84322
2022,10,7,여행,수입,6401,90723
2023,1,3,MT,지출,7965,82758
2020,8,19,쇼핑,수입,2101,84859
2020,2,25,식사,지출,3454,81405
2023,2,27,여행,지출,3926,77479
2022,4,13,여행,지출,4592,72887
2023,7,6,쇼핑,수입,7618,80505
2021,3,22,쇼핑,지출,1023,79482
2023,12,24,체육대회,수입,8212,87694
2022,4,13,여행,지출,9031,78663
2021,10,27,식사,수입,3135,81798
2020,11,10,쇼핑,수입,6087,87885
2020,12,7,여행,수입,2504,90389
2020,2,25,여행,수입,6741,97130
2022,1,8,식사,수입,7718,104848
2023,7,22,체육대회,수입,6666,111514
2020,6,29,식사,수입,4779,116293
2021,3,18,MT,수입,7360,123653
2022,5,31,MT,지출,8780,114873
2023,5,6,체육대회,지출,2732,112141
2022,9,15,MT,수입,2559,114700
2021,11,29,체육대회,수입,3347,118047
2022,4,25,쇼핑,지출,8490,109557
2022,3,5,쇼핑,수입,8122,117679
2020,8,26,식사,수입,5496,123175
2020,5,26,여행,수입,8805,131980
2023,12,27,MT,수입,2168,134148
2020,12,10,체육대회,수입,4202,138350
2022,3,2,식사,지출,6491,131859
2021,7,25,쇼핑,지출,8870,122989
2022,2,7,체육대회,지출,5885,117104
2021,8,5,쇼핑,지출,4508,112596
2023,5,31,여행,수입,1900,114496
2020,4,11,체육대회,지출,5193,109303
2022,10,15,여행,지출,1521,107782
2020,6,22,체육대회,수입,9433,117215
2021,5,24,쇼핑,지출,2094,115121
2023,8,11,식사,수입,1052,116173
2021,1,4,쇼핑,수입,3395,119568
2020,10,17,체육대회,수입,3927,123495
2020,11,5,체육대회,지출,4166,119329
2022,8,3,식사,지출,9307,110022
2023,4,26,체육대회,수입,4270,114292
2022,8,25,식사,지출,1626,112666
2021,4,14,식사,수입,8633,121299
2021,10,3,쇼핑,수입,2916,124215
2021,8,9,체육대회,지출,7185,117030
2023,9,12,식사,지출,8226,108804
2023,4,9,여행,지출,9953,98851
2020,1,15,쇼핑,지출,2272,96579
2021,1,25,쇼핑,지출,7409,89170
2021,9,21,쇼핑,지출,1062,88108
2022,11,25,쇼핑,지출,1571,86537
2022,11,29,쇼핑,지출,4823,81714
2021,11,26,체육대회,지출,5810,75904
2020,3,8,식사,지출,9360,66544
2020,1,30,MT,수입,9280,75824
2021,11,27,쇼핑,수입,4802,80626
2020,3,14,쇼핑,지출,3821,76805
2021,11,10,식사,지출,4848,71957
2023,9,28,쇼핑,지출,5643,66314
2021,4,18,쇼핑,지출,5018,61296
2020,1,10,식사,지출,7815,53481
2022,3,7,체육대회,지출,3871,49610
2021,11,9,체육대회,수입,4646,54256
2020,10,26,체육대회,지출,6765,47491
2023,10,17,체육대회,지출,3164,44327
2020,10,8,MT,지출,8829,35498
2023,9,14,여행,지출,2693,32805
2022,7,9,쇼핑,수입,4769,37574
2021,1,17,식사,지출,8851,28723
2023,12,27,MT,지출,1796,26927
2022,8,31,MT,지출,2325,24602
2021,3,1,여행,수입,3440,28042
2023,1,3,식사,지출,9042,19000
2021,4,3,쇼핑,수입,1789,20789
2022,2,24,식사,수입,6686,27475
2023,2,6,MT,수입,4790,32265
2023,4,16,식사,지출,2589,29676
2022,11,22,MT,수입,1920,31596
2022,10,15,여행,수입,6343,37939
2021,2,26,여행,지출,7361,30578
2023,11,13,체육대회,지출,1263,29315
2023,8,20,식사,수입,1751,31066
2022,7,28,체육대회,지출,3471,27595
2021,2,28,여행,지출,2584,25011
2023,4,12,여행,지출,1135,23876
2022,11,25,MT,수입,4112,27988
2023,5,12,MT,수입,3477,31465
2020,3,16,식사,수입,5216,36681
2021,10,14,체육대회,수입,1445,38126
2023,8,16,쇼핑,지출,5901,32225
2022,4,25,식사,지출,6433,25792
2021,8,27,쇼핑,수입,9670,35462
2021,12,9,MT,수입,7741,43203
2021,2,21,체육대회,수입,3588,46791
2020,4,21,MT,지출,2113,44678
2023,8,16,MT,지출,8152,36526
2023,1,11,체육대회,지출,3319,33207
2021,5,28,MT,수입,7600,40807
2022,5,29,쇼핑,수입,8401,49208
2021,10,28,쇼핑,수입,7855,57063
2020,2,14,쇼핑,수입,2702,59765
2021,3,3,여행,지출,6788,52977
2021,4,10,여행,지출,6408,46569
2021,1,14,MT,지출,7518,39051
2022,3,25,식사,지출,8986,30065
2020,10,10,식사,지출,2470,27595
2021,10,22,여행,지출,2254,25341
2022,5,23,체육대회,지출,8643,16698
2022,5,17,쇼핑,수입,7552,24250
2020,6,22,여행,수입,3472,27722
2022,9,14,여행,지출,7243,20479
2022,12,17,체육대회,수입,3485,23964
2022,7,29,체육대회,수입,8620,32584
2020,6,14,체육대회,수입,1232,33816
2023,3,11,식사,지출,9608,24208
2022,1,9,MT,지출,8667,15541
2022,3,6,여행,지출,7332,8209
2020,11,12,여행,지출,8620,-411
2021,12,17,여행,지출,9754,-10165
2022,2,21,식사,수입,5385,-4780
2023,12,19,여행,수입,8478,3698
2022,11,8,체육대회,수입,3512,7210
2022,12,20,여행,지출,8544,-1334
2021,3,29,식사,수입,4218,2884
2021,5,13,체육대회,지출,8451,-5567
2021,2,10,쇼핑,지출,7769,-13336
2022,2,4,식사,수입,1047,-12289
2022,11,25,쇼핑,지출,6681,-18970
2023,10,30,여행,수입,8864,-10106
2020,2,15,MT,지출,4390,-14496
2022,6,22,쇼핑,수입,6876,-7620
2022,11,6,MT,수입,9118,1498
2023,5,1,식사,수입,4543,6041
2022,7,3,여행,지출,6923,-882
2021,11,21,식사,지출,7030,-7912
2020,4,15,MT,지출,3701,-11613
2021,8,15,여행,지출,4011,-15624
2022,1,24,식사,수입,4094,-11530
2023,10,17,여행,수입,6217,-5313
2020,8,6,쇼핑,지출,7283,-12596
2020,6,25,여행,지출,9721,-22317
2020,7,5,식사,수입,1307,-21010
2021,4,24,여행,지출,8323,-29333
2022,9,20,여행,수입,8206,-21127
2022,6,24,식사,지출,1551,-22678
2023,11,11,여행,수입,6939,-15739
2020,3,20,여행,수입,7147,-8592
2023,7,14,쇼핑,수입,4384,-4208
2023,3,30,체육대회,수입,4111,-97
2022,7,4,쇼핑,지출,3020,-3117
2023,3,31,MT,지출,7576,-10693
2021,11,2,체육대회,수입,1263,-9430
2021,7,18,식사,수입,9084,-346
2020,7,6,쇼핑,지출,6948,-7294
2020,2,10,MT,수입,3529,-3765
2022,3,16,체육대회,지출,1284,-5049
2023,8,28,MT,지출,8454,-13503
2023,11,15,식사,지출,9552,-23055
2020,12,21,MT,수입,5020,-18035
2020,9,30,MT,수입,2959,-15076
2022,2,20,MT,수입,6901,-8175
2020,8,1,MT,수입,9561,1386
2022,9,30,여행,수입,1414,2800
2022,2,24,MT,지출,9826,-7026
2022,3,26,여행,수입,2251,-4775
2022,9,8,MT,수입,1084,-3691
2023,10,17,쇼핑,지출,4960,-8651
2021,12,5,MT,수입,7168,-1483
2022,8,30,여행,수입,7522,6039
2020,12,25,MT,수입,7634,13673
2022,2,9,여행,지출,8485,5188
2020,12,12,체육대회,수입,6230,11418
2020,10,19,여행,수입,8189,19607
2020,6,28,식사,지출,4425,15182
2023,8,12,MT,지출,2558,12624
2020,10,14,여행,지출,6807,5817
2022,11,4,식사,수입,1420,7237
2021,3,21,쇼핑,지출,9650,-2413
2021,5,11,MT,지출,9589,-12002
2022,10,28,체육대회,지출,5072,-17074
2023,5,30,체육대회,수입,9229,-7845
2020,1,7,체육대회,수입,2603,-5242
2020,11,29,체육대회,지출,7439,-12681
2023,4,6,MT,수입,9881,-2800
2021,10,14,식사,지출,5791,-8591
2021,8,25,쇼핑,수입,1559,-7032
2022,9,15,쇼핑,지출,7215,-14247
2021,6,23,MT,지출,7976,-22223
2021,2,17,MT,수입,8573,-13650
2020,3,24,쇼핑,수입,5277,-8373
2023,2,13,여행,수입,8857,484
2022,6,24,여행,수입,2157,2641
2022,12,20,여행,수입,2227,4868
2023,9,3,쇼핑,수입,9294,14162
2020,9,16,식사,수입,8898,23060
2020,11,1,체육대회,지출,5304,17756
2023,8,1,쇼핑,지출,7702,10054
2022,6,8,여행,수입,2462,12516
2020,2,7,여행,수입,9311,21827
2022,5,18,식사,수입,8860,30687
2023,4,28,식사,지출,6913,23774
2023,7,5,쇼핑,지출,6508,17266
2022,8,27,쇼핑,지출,4024,13242
2020,10,3,여행,지출,3097,10145
2020,8,9,MT,수입,6865,17010
2023,9,24,식사,지출,9992,7018
2021,9,8,쇼핑,지출,8174,-1156
2021,8,17,식사,지출,1925,-3081
2021,10,21,체육대회,수입,1477,-1604
2023,4,18,여행,수입,9474,7870
2022,3,11,식사,수입,6791,14661
2023,2,25,MT,수입,2828,17489
2023,1,10,MT,수입,1195,18684
2021,9,19,체육대회,지출,4180,14504
2020,9,17,체육대회,지출,6468,8036
2020,5,22,여행,수입,6711,14747
2022,4,26,체육대회,수입,8057,22804
2023,8,2,여행,지출,5412,17392
2023,3,25,쇼핑,수입,3478,20870
2023,6,18,쇼핑,수입,9082,29952
2021,9,15,식사,지출,3715,26237
2022,5,11,MT,지출,5183,21054
2021,12,8,여행,지출,4528,16526
2020,7,17,여행,수입,8017,24543
2022,4,6,쇼핑,수입,9946,34489
2022,10,27,체육대회,지출,7175,27314
2021,3,9,체육대회,수입,7733,35047
2023,6,1,쇼핑,지출,9569,25478
2022,10,13,여행,지출,5126,20352
2023,4,16,식사,지출,2021,18331
2022,8,13,식사,지출,7590,10741
2023,12,10,MT,수입,2871,13612
2020,3,10,쇼핑,지출,8869,4743
2023,3,14,쇼핑,수입,9529,14272
2020,1,11,쇼핑,지출,8407,5865
2023,1,16,MT,수입,1756,7621
2020,5,29,쇼핑,지출,6311,1310
2020,11,10,쇼핑,지출,6504,-5194
2023,5,18,여행,지출,4437,-9631
2020,5,9,쇼핑,수입,1973,-7658
2022,12,15,여행,수입,7324,-334
2020,12,6,MT,수입,1329,995
2022,7,2,쇼핑,지출,2756,-1761
2023,2,5,여행,수입,6359,4598
2020,10,29,체육대회,지출,5670,-1072
2022,9,8,쇼핑,수입,2679,1607
2023,8,3,쇼핑,지출,8550,-6943
2023,6,1,쇼핑,수입,7613,670
2020,12,15,MT,수입,9460,10130
2022,2,11,식사,지출,2503,7627
2023,4,10,MT,수입,7309,14936
2023,8,5,식사,지출,4795,10141
2021,2,10,식사,지출,3498,6643
2020,10,14,MT,지출,9232,-2589
2020,9,16,쇼핑,수입,8006,5417
2023,10,16,쇼핑,수입,1706,7123
2022,4,12,쇼핑,지출,1940,5183
2023,6,6,체육대회,수입,7949,13132
2020,3,1,MT,지출,8827,4305
2023,12,10,MT,지출,7933,-3628
2021,8,17,식사,지출,8077,-11705
2021,6,26,쇼핑,지출,4584,-16289
2021,1,4,체육대회,지출,4897,-21186
2020,12,27,MT,지출,6693,-27879
2022,6,27,쇼핑,수입,7911,-19968
2023,4,5,여행,수입,5003,-14965
2021,3,29,MT,지출,2402,-17367
2020,3,1,MT,지출,2942,-20309
2023,11,23,쇼핑,수입,7746,-12563
2023,12,30,쇼핑,지출,9401,-21964
2021,8,18,식사,지출,9630,-31594
2021,10,9,체육대회,지출,9657,-41251
2023,3,15,식사,수입,1854,-39397
2022,6,21,여행,지출,7420,-46817
2020,4,4,체육대회,지출,6256,-53073
2022,7,15,MT,지출,4805,-57878
2020,3,27,여행,지출,5436,-63314
2023,7,19,여행,지출,8753,-72067
2021,3,31,MT,지출,1013,-73080
2021,12,29,체육대회,지출,4047,-77127
2021,10,2,체육대회,수입,6970,-70157
2020,12,23,MT,지출,9085,-79242
2022,4,13,여행,수입,2840,-76402
2021,12,23,MT,수입,6644,-69758
2023,4,14,쇼핑,수입,2469,-67289
2021,5,27,여행,수입,8783,-58506
2022,2,26,식사,지출,9822,-68328
2023,8,19,MT,수입,7301,-61027
2023,11,20,여행,지출,3588,-64615
2023,11,18,쇼핑,수입,6516,-58099
2023,1,28,쇼핑,수입,3380,-54719
2021,7,12,MT,지출,7750,-62469
2021,6,11,MT,지출,5143,-67612
2020,10,28,MT,지출,9652,-77264
2022,8,28,식사,수입,5493,-71771
2020,12,19,MT,지출,1619,-73390
2022,11,16,식사,지출,3966,-77356
2023,9,20,여행,지출,7896,-85252
2021,6,22,여행,수입,9177,-76075
2020,4,1,MT,수입,3124,-72951
2023,12,17,체육대회,지출,9030,-81981
2022,5,8,여행,지출,4951,-86932
2020,8,18,식사,수입,9415,-77517
2020,12,24,MT,수입,9208,-68309
2022,2,9,체육대회,지출,3889,-72198
2023,1,27,식사,지출,1164,-73362
2021,5,25,여행,수입,1250,-72112
2022,2,20,체육대회,지출,5356,-77468
2022,3,21,식사,지출,8754,-86222
2020,4,28,식사,수입,9458,-76764
2021,9,10,체육대회,지출,8894,-85658
2020,3,20,체육대회,수입,9618,-76040
2023,8,16,쇼핑,지출,6003,-82043
2023,3,2,여행,수입,5571,-76472
2022,2,1,여행,수입,5634,-70838
2022,4,7,식사,수입,8474,-62364
2021,8,30,MT,지출,2536,-64900
2020,2,2,쇼핑,지출,9101,-74001
2020,7,6,식사,지출,2600,-76601
2020,5,10,여행,지출,6040,-82641
2023,1,4,식사,지출,9594,-92235
2021,6,26,식사,수입,5094,-87141
2021,9,19,MT,수입,8551,-78590
2021,4,14,MT,수입,5464,-73126
2021,2,20,MT,수입,4048,-69078
2023,11,15,쇼핑,수입,1203,-67875
2021,12,25,식사,수입,7609,-60266
2022,2,17,MT,지출,3413,-63679
2022,2,17,여행,수입,4629,-59050
2023,11,7,여행,지출,2618,-61668
2023,3,30,여행,수입,8166,-53502
2023,9,9,체육대회,수입,8926,-44576
2020,2,18,MT,수입,7301,-37275
2023,7,15,식사,수입,2761,-34514
2023,6,17,여행,지출,7434,-41948
2021,5,29,식사,지출,7319,-49267
2021,2,4,체육대회,수입,8768,-40499
2023,1,22,MT,지출,5637,-46136
2021,9,22,쇼핑,지출,1286,-47422
2022,12,7,체육대회,수입,6695,-40727
2021,1,23,쇼핑,수입,4812,-35915
2023,8,26,체육대회,지출,2162,-38077
2020,10,2,MT,지출,3285,-41362
2021,7,4,식사,수입,7626,-33736
2020,3,27,MT,수입,2606,-31130
2022,1,7,식사,지출,5208,-36338
2020,1,6,여행,수입,1263,-35075
2023,11,3,쇼핑,지출,3893,-38968
2023,7,10,여행,지출,8614,-47582
2020,6,3,MT,수입,5762,-41820
2023,8,31,체육대회,지출,5743,-47563
2023,3,31,여행,수입,4500,-43063
2023,10,23,체육대회,지출,4095,-47158
2020,11,16,여행,수입,1545,-45613
2022,12,11,여행,지출,6280,-51893
2021,9,13,MT,지출,6322,-58215
2023,5,15,여행,지출,5213,-63428
2022,9,21,쇼핑,지출,2654,-66082
2022,4,15,여행,수입,9535,-56547
2023,4,16,쇼핑,지출,6945,-63492
2020,6,9,여행,지출,7133,-70625
2022,4,23,식사,수입,5860,-64765
2020,9,26,식사,지출,7489,-72254
2023,2,11,여행,수입,4742,-67512
2022,4,7,쇼핑,수입,3951,-63561
2020,5,27,MT,수입,8269,-55292
2020,3,16,여행,지출,2613,-57905
2022,11,23,쇼핑,수입,5582,-52323
2023,7,14,여행,지출,6521,-58844
2020,3,20,여행,지출,8138,-66982
2020,11,5,쇼핑,지출,7967,-74949
2020,4,26,여행,수입,5245,-69704
2021,12,6,체육대회,지출,2594,-72298
2023,6,4,여행,지출,1809,-74107
2022,12,20,체육대회,수입,8865,-65242
2020,5,12,식사,수입,7898,-57344
2023,4,16,여행,수입,6786,-50558
2022,1,25,체육대회,수입,8531,-42027
2023,10,29,식사,수입,7339,-34688
2021,9,22,MT,수입,9193,-25495
2023,5,22,MT,수입,4905,-20590
2020,5,8,쇼핑,수입,8400,-12190
2022,11,7,체육대회,수입,8766,-3424
2022,9,6,MT,지출,8911,-12335
2020,9,6,체육대회,수입,9131,-3204
2021,12,18,여행,지출,1629,-4833
2023,1,15,MT,수입,4819,-14
2021,10,10,식사,지출,9596,-9610
2023,2,22,식사,수입,7019,-2591
2021,1,5,여행,지출,9059,-11650
2020,1,15,쇼핑,지출,8081,-19731
2023,9,15,여행,지출,7527,-27258
2020,10,8,체육대회,수입,4719,-22539
2023,7,8,MT,지출,7645,-30184
2023,1,2,여행,수입,1920,-28264
2022,9,25,여행,수입,2217,-26047
2020,7,28,체육대회,지출,1009,-27056
2022,11,16,여행,수입,4221,-22835
2020,8,9,체육대회,수입,6547,-16288
2023,9,21,체육대회,수입,9665,-6623
2020,10,30,MT,수입,8925,2302
2023,6,30,식사,수입,5738,8040
2022,12,7,쇼핑,수입,5674,13714
2021,6,5,체육대회,지출,9664,4050
2021,7,12,체육대회,수입,7443,11493
2022,9,28,식사,수입,7514,19007
2022,5,26,여행,지출,6443,12564
2022,1,27,여행,수입,9548,22112
2022,12,23,쇼핑,수입,1362,23474
2023,10,31,여행,수입,4971,28445
2021,1,9,MT,지출,7696,20749
2022,11,6,체육대회,지출,4430,16319
2021,6,26,MT,지출,2145,14174
2022,4,10,여행,수입,7622,21796
2020,9,6,여행,지출,7182,14614
2020,1,22,쇼핑,수입,3618,18232
2021,7,20,MT,지출,4824,13408
2021,2,11,체육대회,지출,4753,8655
2022,9,27,여행,수입,3478,12133
2021,10,14,체육대회,지출,4770,7363
2022,11,13,여행,지출,4017,3346
2020,6,15,체육대회,지출,2415,931
2022,9,6,여행,수입,1124,2055
2020,7,30,식사,지출,2329,-274
2020,9,19,식사,지출,6157,-6431
2022,7,25,MT,수입,2774,-3657
2023,6,29,여행,지출,6982,-10639
2023,1,3,식사,수입,5247,-5392
2021,12,5,여행,수입,1594,-3798
2020,7,30,체육대회,지출,4005,-7803
2022,5,6,MT,지출,5536,-13339
2020,11,26,쇼핑,지출,8599,-21938
2023,4,16,식사,지출,4245,-26183
2021,1,9,여행,수입,8412,-17771
2023,1,6,여행,지출,2349,-20120
2021,3,20,MT,지출,5599,-25719
2021,10,26,체육대회,지출,8908,-34627
2022,3,12,여행,지출,2322,-36949
2023,3,25,MT,지출,2646,-39595
2023,10,19,여행,수입,4140,-35455
2021,5,18,여행,지출,9566,-45021
2022,1,17,쇼핑,수입,9079,-35942
2020,9,15,체육대회,수입,2487,-33455
2020,1,17,MT,수입,7412,-26043
2021,5,18,식사,수입,1092,-24951
2020,11,4,MT,지출,3915,-28866
2021,10,9,식사,수입,5120,-23746
2023,4,10,쇼핑,지출,8490,-32236
2023,4,4,MT,지출,8165,-40401
2021,5,17,MT,지출,9878,-50279
2021,8,16,MT,수입,2752,-47527
2022,4,16,MT,지출,3038,-50565
2021,6,25,체육대회,지출,2746,-53311
2020,9,6,체육대회,수입,6483,-46828
2021,6,21,MT,지출,8718,-55546
2020,7,26,식사,지출,2866,-58412
2021,3,25,체육대회,수입,3325,-55087
2021,6,2,여행,지출,9105,-64192
2022,7,26,쇼핑,지출,8256,-72448
2023,8,3,쇼핑,수입,1482,-70966
2021,5,17,여행,수입,3859,-67107
2022,3,2,체육대회,수입,3228,-63879
2022,10,30,체육대회,수입,2603,-61276
2021,1,23,MT,수입,4311,-56965
2021,8,13,여행,수입,6549,-50416
2023,3,18,식사,지출,6319,-56735
2020,8,26,MT,수입,3950,-52785
2020,1,21,여행,지출,4277,-57062
2023,2,22,여행,지출,3058,-60120
2023,2,13,체육대회,지출,1749,-61869
2023,4,21,MT,수입,3452,-58417
2020,11,22,여행,지출,5156,-63573
2021,2,28,쇼핑,지출,3885,-67458
2023,6,13,MT,수입,9138,-58320
2023,6,21,체육대회,지출,2615,-60935
2023,10,10,체육대회,수입,8606,-52329
2021,2,27,쇼핑,지출,2160,-54489
2021,5,24,MT,수입,9091,-45398
2020,10,25,여행,지출,2325,-47723
2023,6,27,체육대회,지출,1883,-49606
2022,8,2,여행,수입,8536,-41070
2022,11,11,MT,지출,2692,-43762
2020,2,5,여행,지출,6189,-49951
2023,4,6,쇼핑,지출,2450,-52401
2023,2,20,MT,수입,9562,-42839
2022,1,31,식사,수입,8438,-34401
2022,9,16,체육대회,지출,8298,-42699
2020,10,29,MT,지출,1602,-44301
2021,10,14,MT,지출,9055,-53356
2021,12,10,쇼핑,지출,8731,-62087
2020,2,23,식사,수입,5668,-56419
2021,12,24,식사,수입,8646,-47773
2020,6,8,여행,수입,9761,-38012
2022,6,19,MT,지출,8404,-46416
2022,1,30,체육대회,수입,7413,-39003
2022,10,24,식사,지출,8318,-47321
2023,11,28,MT,지출,1545,-48866
2022,8,26,쇼핑,수입,7066,-41800
2021,1,15,식사,지출,3064,-44864
2021,11,24,여행,지출,7312,-52176
2021,2,11,MT,지출,7640,-59816
2020,7,13,MT,수입,4860,-54956
2022,5,18,체육대회,수입,5342,-49614
2023,9,26,여행,지출,1577,-51191
2022,2,7,체육대회,수입,3886,-47305
2022,12,27,쇼핑,지출,4532,-51837
2022,9,6,MT,지출,9724,-61561
2022,5,30,MT,수입,8007,-53554
2023,6,17,체육대회,수입,7177,-46377
2021,7,14,여행,수입,1200,-45177
2023,2,15,쇼핑,수입,1679,-43498
2020,11,15,체육대회,지출,1503,-45001
2022,4,11,MT,지출,1119,-46120
2020,8,1,여행,수입,7040,-39080
2020,7,2,MT,수입,6201,-32879
2022,6,18,MT,지출,5199,-38078
2020,1,21,쇼핑,지출,9973,-48051
2020,11,11,쇼핑,지출,7815,-55866
2022,7,8,식사,수입,8941,-46925
2021,8,6,MT,수입,7799,-39126
2022,9,6,여행,수입,1389,-37737
2021,12,16,식사,지출,3482,-41219
2020,6,16,식사,수입,3792,-37427
2023,8,5,식사,수입,7446,-29981
2023,8,11,체육대회,지출,5799,-35780
2023,1,20,쇼핑,지출,5327,-41107
2020,2,26,MT,지출,4617,-45724
2021,2,27,MT,수입,6721,-39003
2023,5,1,여행,수입,6207,-32796
2023,3,26,체육대회,수입,4368,-28428
2023,11,7,여행,수입,5075,-23353
2021,2,3,여행,지출,9134,-32487
2023,11,8,여행,수입,4408,-28079
2021,2,22,여행,지출,7566,-35645
2021,5,26,여행,지출,2687,-38332
2020,4,10,여행,지출,1256,-39588
2021,9,22,식사,수입,5293,-34295
2023,2,18,식사,지출,3194,-37489
2023,1,25,쇼핑,수입,7217,-30272
2021,10,9,식사,지출,2634,-32906
2021,9,26,체육대회,지출,3233,-36139
2021,11,2,MT,수입,9839,-26300
2022,3,17,여행,수입,4103,-22197
2023,10,1,쇼핑,수입,9858,-12339
2021,3,14,MT,지출,4639,-16978
2023,3,7,체육대회,지출,5448,-22426
2020,10,26,MT,수입,4761,-17665
2020,10,26,식사,수입,2124,-15541
2021,4,27,쇼핑,지출,7535,-23076
2020,12,5,쇼핑,지출,1495,-24571
2021,3,26,체육대회,지출,9938,-34509
2020,3,13,식사,수입,1759,-32750
2020,8,19,쇼핑,수입,2378,-30372
2021,1,17,식사,수입,3649,-26723
2023,12,9,여행,지출,9188,-35911
2020,10,17,MT,수입,5306,-30605
2023,10,24,체육대회,지출,3975,-34580
2022,3,29,체육대회,지출,1590,-36170
2023,9,1,식사,수입,6174,-29996
2021,6,11,여행,수입,8799,-21197
2020,10,28,식사,수입,7573,-13624
2022,10,27,쇼핑,수입,2802,-10822
2021,7,20,MT,지출,8856,-19678
2022,9,20,MT,수입,3969,-15709
2020,11,20,체육대회,지출,5594,-21303
2021,6,21,여행,수입,5585,-15718
2022,2,1,체육대회,지출,1494,-17212
2023,10,11,식사,지출,4831,-22043
2020,12,31,쇼핑,수입,3386,-18657
2022,5,24,체육대회,지출,3000,-21657
2021,1,30,MT,지출,9940,-31597
2021,3,22,여행,지출,5918,-37515
2020,12,8,여행,수입,4558,-32957
2023,3,30,여행,지출,3586,-36543
2022,11,6,MT,지출,8298,-44841
2021,4,13,쇼핑,지출,2595,-47436
2020,3,18,MT,수입,4308,-43128
2021,4,14,MT,지출,8032,-51160
2020,3,22,MT,지출,9979,-61139
2021,3,23,식사,수입,3321,-57818
2020,7,18,체육대회,수입,6852,-50966
2020,10,21,체육대회,수입,3047,-47919
2023,11,14,여행,수입,7140,-40779
2022,5,4,쇼핑,지출,3596,-44375
2023,6,25,체육대회,수입,5446,-38929
2023,12,30,쇼핑,지출,8493,-47422
2020,3,19,쇼핑,수입,7511,-39911
2022,2,15,쇼핑,지출,5079,-44990
2021,11,17,체육대회,수입,8431,-36559
2020,11,25,여행,수입,5679,-30880
2020,5,20,체육대회,수입,3255,-27625
2021,2,2,여행,수입,3373,-24252
2023,6,10,쇼핑,지출,3521,-27773
2023,3,6,여행,수입,5163,-22610
2020,4,28,식사,지출,4325,-26935
2022,10,24,체육대회,수입,2110,-24825
2023,11,17,체육대회,수입,3544,-21281
2020,6,20,MT,수입,8622,-12659
2023,4,13,쇼핑,수입,8105,-4554
2021,6,30,식사,수입,8113,3559
2020,10,4,체육대회,지출,7990,-4431
2022,9,7,여행,지출,8437,-12868
2023,11,6,체육대회,수입,6898,-5970
2023,1,20,여행,지출,8728,-14698
2023,6,29,MT,지출,3883,-18581
2023,9,20,여행,지출,3467,-22048
2023,10,21,MT,지출,3523,-25571
2022,7,23,여행,수입,3798,-21773
2023,6,3,체육대회,지출,2624,-24397
2022,8,3,MT,지출,4850,-29247
2022,3,15,체육대회,지출,7849,-37096
2020,1,28,쇼핑,지출,1427,-38523
2020,7,4,쇼핑,지출,1954,-40477
2020,8,13,식사,지출,7767,-48244
2023,3,15,체육대회,지출,4772,-53016
2023,8,25,쇼핑,수입,6302,-46714
2021,3,24,체육대회,지출,4134,-50848
2022,11,8,쇼핑,수입,9989,-40859
2022,12,15,MT,수입,6566,-34293
2023,8,20,여행,수입,1274,-33019
2022,4,3,여행,수입,5550,-27469
2022,9,30,체육대회,지출,1557,-29026
2021,6,18,쇼핑,지출,9193,-38219
2023,2,6,식사,지출,5278,-43497
2022,7,25,여행,지출,6988,-50485
2020,10,28,쇼핑,지출,3019,-53504
2021,11,9,체육대회,수입,2420,-51084
2021,3,14,여행,수입,9848,-41236
2023,8,29,체육대회,수입,6735,-34501
2022,1,16,체육대회,지출,2991,-37492
2022,5,23,체육대회,지출,4594,-42086
2021,8,29,MT,수입,9339,-32747
2023,3,1,MT,수입,5465,-27282
2023,3,18,여행,수입,6246,-21036
2023,7,19,체육대회,지출,2795,-23831
2020,6,7,체육대회,수입,2634,-21197
2022,9,19,식사,수입,5698,-15499
2021,6,6,쇼핑,지출,7213,-22712
2022,9,22,쇼핑,지출,7478,-30190
2022,10,29,쇼핑,지출,3976,-34166
2021,2,7,식사,수입,3365,-30801
2023,5,19,쇼핑,수입,7909,-22892
2020,3,7,식사,수입,6676,-16216
2021,1,6,여행,수입,5237,-10979
2021,9,23,식사,지출,4179,-15158
2022,11,4,MT,지출,4483,-19641
2020,4,15,식사,지출,6253,-25894
2020,8,31,MT,수입,9342,-16552
2022,4,30,여행,지출,4633,-21185
2022,3,9,MT,지출,4087,-25272
2020,10,30,여행,지출,3954,-29226
2021,10,19,쇼핑,지출,8984,-38210
2023,1,3,MT,지출,9328,-47538
2020,5,10,여행,수입,1755,-45783
2023,10,15,MT,지출,2915,-48698
2022,1,10,MT,지출,8093,-56791
2022,5,18,MT,수입,5826,-50965
2020,12,9,여행,수입,5920,-45045
2021,4,28,MT,수입,6795,-38250
2023,1,4,쇼핑,지출,4575,-42825
2022,9,21,쇼핑,수입,7024,-35801
2023,1,28,식사,수입,4573,-31228
2023,4,24,MT,지출,6966,-38194
2022,4,24,식사,지출,8332,-46526
2020,11,17,여행,수입,2758,-43768
2021,8,14,MT,수입,3155,-40613
2021,6,18,쇼핑,수입,9601,-31012
2022,8,23,식사,지출,8422,-39434
2021,2,7,여행,수입,1757,-37677
2022,8,29,체육대회,수입,1970,-35707
2021,11,26,여행,수입,5144,-30563
2022,12,9,체육대회,수입,3728,-26835
2022,3,12,여행,수입,1605,-25230
2021,8,19,체육대회,지출,5654,-30884
2021,8,29,MT,수입,8344,-22540
2021,12,30,식사,지출,9272,-31812
2023,3,27,MT,지출,1211,-33023
2021,4,19,체육대회,지출,9744,-42767
2023,12,18,여행,지출,8743,-51510
2022,3,15,쇼핑,수입,6401,-45109
2022,10,17,여행,수입,2084,-43025
2021,8,9,여행,지출,9345,-52370
2023,10,14,체육대회,수입,1041,-51329
2023,7,1,쇼핑,지출,6326,-57655
2022,7,13,쇼핑,지출,9295,-66950
2023,1,25,식사,지출,8768,-75718
2021,10,18,쇼핑,수입,5541,-70177
2023,12,28,MT,지출,6100,-76277
2023,12,16,여행,지출,3785,-80062
2021,2,24,체육대회,지출,6869,-86931
2020,12,16,MT,수입,6064,-80867
2023,10,14,MT,수입,7605,-73262
2022,8,8,식사,지출,4971,-78233
2023,9,23,쇼핑,수입,8448,-69785
2023,10,14,여행,수입,4995,-64790
2020,1,29,식사,수입,5288,-59502
2023,9,4,쇼핑,수입,4317,-55185
2023,7,9,쇼핑,수입,2595,-52590
2023,5,24,MT,수입,8785,-43805
2023,8,23,식사,지출,7189,-50994
2023,10,5,체육대회,지출,9007,-60001
2023,9,5,MT,수입,6595,-53406
2022,10,31,식사,지출,8799,-62205
2023,2,24,식사,수입,1979,-60226
2023,1,31,쇼핑,지출,2095,-62321
2023,7,5,쇼핑,지출,1325,-63646
2020,4,14,체육대회,수입,7917,-55729
2021,6,20,쇼핑,지출,4260,-59989
2022,10,24,식사,수입,6456,-53533
2020,7,14,체육대회,수입,6366,-47167
2020,7,19,체육대회,수입,1665,-45502
2021,3,15,식사,지출,8950,-54452
2020,7,10,체육대회,수입,1005,-53447
2023,8,8,쇼핑,지출,6083,-59530
2022,5,4,여행,수입,5537,-53993
2022,3,20,MT,수입,4729,-49264
2023,10,19,식사,수입,5018,-44246
2021,6,29,쇼핑,지출,6483,-50729
2022,3,16,MT,지출,7846,-58575
2021,1,26,식사,지출,7808,-66383
2020,1,24,쇼핑,수입,1642,-64741
2022,5,20,체육대회,지출,9433,-74174
2020,11,24,식사,수입,3807,-70367
2022,2,15,여행,지출,9982,-80349
2021,4,15,쇼핑,수입,9089,-71260
2023,6,16,식사,수입,1957,-69303
2023,5,15,체육대회,지출,2794,-72097
2020,8,4,여행,지출,5981,-78078
2020,6,14,여행,수입,9446,-68632
2022,7,6,MT,지출,3925,-72557
2022,1,4,식사,지출,3063,-75620
2022,6,16,여행,수입,5744,-69876
2023,8,9,쇼핑,수입,6821,-63055
2021,10,29,MT,수입,2659,-60396
2020,8,22,MT,수입,9504,-50892
2020,3,13,여행,지출,2178,-53070
2023,10,2,식사,수입,1968,-51102
2022,12,4,MT,수입,3334,-47768
2021,10,21,쇼핑,수입,6235,-41533
2021,10,28,체육대회,수입,5828,-35705
2020,5,9,체육대회,지출,2308,-38013
2020,8,25,체육대회,지출,7277,-45290
2021,11,3,체육대회,지출,3287,-48577
2022,7,27,MT,수입,2801,-45776
2021,4,28,식사,지출,1537,-47313
2022,2,17,쇼핑,지출,4270,-51583
2020,1,8,체육대회,수입,3670,-47913
2022,7,26,식사,수입,7936,-39977
2023,2,7,여행,지출,5970,-45947
2020,12,17,여행,수입,8636,-37311
2022,11,7,여행,지출,5387,-42698
2020,2,17,체육대회,수입,8801,-33897
2021,10,19,식사,수입,4455,-29442
2022,2,27,체육대회,지출,2543,-31985
2021,9,17,식사,지출,2825,-34810
2021,8,31,MT,지출,6541,-41351
2023,9,24,식사,수입,2328,-39023
2020,11,26,식사,지출,2688,-41711
2022,9,9,쇼핑,지출,4084,-45795
2022,5,7,쇼핑,지출,4186,-49981
2022,12,9,체육대회,수입,8156,-41825
2021,9,1,쇼핑,수입,7057,-34768
2022,1,10,체육대회,수입,4470,-30298
2020,7,21,MT,지출,7341,-37639
2021,11,8,쇼핑,수입,3677,-33962
2020,7,25,식사,수입,8096,-25866
2022,11,27,MT,지출,3710,-29576
2023,9,10,여행,지출,6236,-35812
2022,12,6,쇼핑,지출,5213,-41025
2021,5,29,MT,지출,8176,-49201
2023,3,8,체육대회,수입,9217,-39984
2020,8,19,쇼핑,지출,1222,-41206
2020,3,14,식사,지출,8215,-49421
2022,8,13,쇼핑,지출,1078,-50499
2022,4,18,MT,수입,3311,-47188
2020,2,22,MT,수입,7297,-39891
2021,6,14,체육대회,지출,5738,-45629
2022,1,5,체육대회,지출,5063,-50692
2021,4,8,식사,지출,4394,-55086
2021,11,19,MT,지출,3659,-58745
2020,9,5,MT,지출,8717,-67462
2021,11,6,체육대회,수입,5171,-62291
2022,11,6,식사,지출,3029,-65320
2023,2,5,MT,수입,9446,-55874
2023,6,13,식사,지출,3841,-59715
2020,8,26,체육대회,수입,9523,-50192
2023,9,10,여행,수입,2367,-47825
2021,2,21,MT,수입,8545,-39280
2022,7,7,여행,지출,1259,-40539
2020,6,1,MT,지출,8143,-48682
2020,1,23,식사,지출,5862,-54544
2021,12,17,식사,수입,4866,-49678
2023,5,29,여행,지출,7009,-56687
2021,5,18,식사,수입,4757,-51930
2020,8,9,체육대회,수입,3937,-47993
2023,5,9,식사,지출,4280,-52273
2023,5,1,식사,지출,2521,-54794
2023,10,24,식사,수입,9028,-45766
2021,5,16,체육대회,수입,9118,-36648
2023,1,23,식사,수입,8935,-27713
2022,4,12,체육대회,수입,7640,-20073
2022,10,1,식사,지출,3442,-23515
2023,1,6,체육대회,지출,8873,-32388
2021,2,13,여행,지출,6708,-39096
2021,5,29,식사,지출,2390,-41486
2020,7,14,MT,지출,1485,-42971
2023,9,28,MT,수입,8865,-34106
2022,9,9,여행,수입,5714,-28392
2020,11,25,MT,수입,2016,-26376
2022,2,8,식사,수입,8780,-17596
2022,8,20,체육대회,수입,8032,-9564
2020,7,20,쇼핑,수입,9188,-376
2022,1,26,MT,수입,7065,6689
2023,7,27,식사,지출,7940,-1251
2020,5,10,MT,수입,3488,2237
2022,1,13,MT,수입,8990,11227
2023,8,24,쇼핑,수입,6082,17309
2021,9,20,여행,수입,5714,23023
2020,6,12,여행,지출,7595,15428
2023,4,8,쇼핑,수입,1697,17125
2020,3,2,여행,수입,7621,24746
2020,4,5,여행,지출,9776,14970
2022,11,17,식사,지출,4707,10263
2023,9,14,식사,지출,9420,843
2022,7,3,여행,수입,4276,5119
2022,4,20,여행,수입,7233,12352
2022,11,1,쇼핑,수입,6730,19082
2023,1,31,쇼핑,지출,1124,17958
2022,4,6,체육대회,지출,1611,16347
2021,6,13,식사,수입,6553,22900
2020,4,16,여행,수입,8957,31857
2022,9,21,체육대회,수입,2255,34112
2022,1,31,MT,지출,1940,32172
2021,11,22,식사,지출,2666,29506
2022,9,24,식사,지출,5248,24258
2023,6,3,여행,수입,5902,30160
2022,5,11,쇼핑,수입,6173,36333
2020,12,8,MT,지출,7612,28721
2021,12,26,여행,수입,8346,37067
2020,10,6,체육대회,지출,6608,30459
2022,4,17,MT,수입,8722,39181
2023,3,30,식사,지출,3671,35510
2021,6,12,체육대회,지출,8035,27475
2022,1,6,MT,수입,2017,29492
2022,9,19,MT,수입,2389,31881
2023,7,4,식사,지출,5883,25998
2022,8,2,여행,지출,1214,24784
2021,3,8,체육대회,수입,4743,29527
2020,5,30,체육대회,지출,2608,26919
2021,12,4,쇼핑,지출,2988,23931
2020,3,26,MT,수입,4019,27950
2022,10,22,식사,지출,7112,20838
2022,7,6,식사,지출,1366,19472
2022,8,31,MT,수입,7061,26533
2023,9,25,식사,지출,8306,18227
2022,8,10,여행,수입,6823,25050
2023,10,12,MT,수입,6942,31992
2023,7,4,쇼핑,지출,1967,30025
2021,3,12,여행,지출,2275,27750
2020,1,27,MT,지출,9825,17925
2022,1,27,쇼핑,수입,7177,25102
2021,7,30,식사,지출,5765,19337
2020,7,24,여행,지출,6911,12426
2022,2,5,쇼핑,수입,8479,20905
2023,9,11,체육대회,수입,2489,23394
2023,1,20,여행,수입,3772,27166
2023,10,10,체육대회,지출,3056,24110
2021,11,10,쇼핑,수입,4174,28284
2021,3,10,MT,수입,8540,36824
2020,8,23,체육대회,지출,9507,27317
2023,9,23,쇼핑,지출,2391,24926
2022,9,13,체육대회,지출,8515,16411
2020,3,2,MT,수입,3866,20277
2020,12,25,체육대회,수입,1793,22070
2020,2,11,식사,수입,7681,29751
2022,2,25,식사,수입,8289,38040
2022,8,19,체육대회,수입,1036,39076
2021,9,7,식사,수입,6997,46073
2021,2,26,쇼핑,수입,7502,53575
2021,5,23,쇼핑,수입,9491,63066
2021,5,22,MT,지출,1956,61110
2022,3,1,MT,수입,1315,62425
2021,5,1,MT,지출,2890,59535
2022,10,22,MT,수입,8536,68071
2023,3,8,MT,지출,8231,59840
2023,12,22,여행,지출,8177,51663
2023,8,1,식사,지출,3218,48445
2020,9,24,쇼핑,지출,9749,38696
2022,9,10,쇼핑,수입,8527,47223
2021,8,2,MT,수입,7311,54534
2022,11,20,여행,수입,6864,61398
2020,12,7,MT,수입,6394,67792
2020,11,25,체육대회,수입,6510,74302
2023,1,3,체육대회,지출,2954,71348
2021,7,5,식사,지출,7356,63992
2020,7,21,식사,지출,9969,54023
2020,3,14,MT,지출,3635,50388
2021,5,19,여행,지출,5938,44450
2020,8,7,MT,지출,2870,41580
2022,5,4,식사,지출,3139,38441
2022,3,12,MT,수입,4775,43216
2023,4,19,여행,지출,3452,39764
2020,2,1,MT,지출,1236,38528
2023,11,14,MT,수입,6518,45046
2023,7,20,쇼핑,지출,1208,43838
2023,7,31,여행,지출,7841,35997
2021,9,9,여행,수입,3531,39528
2021,5,26,식사,지출,1928,37600
2020,4,5,여행,수입,1652,39252
2023,12,16,체육대회,지출,8977,30275
2021,10,2,쇼핑,수입,5344,35619
2023,6,22,쇼핑,지출,9203,26416
2022,1,3,MT,수입,5303,31719
2023,3,10,쇼핑,지출,4223,27496
2022,6,18,여행,지출,1634,25862
2023,12,17,MT,지출,7067,18795
2020,7,22,쇼핑,지출,2625,16170
2020,11,23,여행,지출,3506,12664
2023,2,4,MT,수입,2222,14886
2020,3,9,식사,수입,8416,23302
2023,5,11,MT,지출,3891,19411
2023,10,23,MT,지출,8988,10423
2023,7,17,식사,지출,3231,7192
2023,1,18,MT,수입,5809,13001
2020,5,5,식사,수입,5578,18579
2023,8,14,체육대회,수입,7280,25859
2022,7,22,체육대회,수입,7409,33268
2021,8,21,여행,지출,3494,29774
2022,3,30,MT,지출,4809,24965
2023,6,1,MT,수입,6376,31341
2022,12,28,MT,수입,5053,36394
2022,6,6,쇼핑,수입,6375,42769
2022,12,8,식사,지출,6786,35983
2021,11,13,체육대회,지출,6628,29355
2022,3,29,쇼핑,수입,1698,31053
2020,4,12,여행,수입,1051,32104
2020,11,7,체육대회,수입,3971,36075
2022,12,30,식사,수입,2567,38642
2020,10,28,식사,지출,9638,29004
2023,6,14,식사,수입,7311,36315
2023,1,4,MT,지출,5622,30693
2020,4,19,MT,지출,5962,24731
2020,3,5,체육대회,지출,2288,22443
2021,3,13,체육대회,수입,3730,26173
2022,3,30,식사,수입,5393,31566
2020,1,4,쇼핑,수입,2311,33877
2022,5,6,MT,수입,6239,40116
2021,3,5,MT,지출,6382,33734
2021,12,23,식사,수입,2436,36170
2021,7,28,여행,수입,1884,38054
2022,9,29,체육대회,지출,8295,29759
2022,11,6,여행,수입,3870,33629
2022,9,13,쇼핑,수입,6579,40208
2021,5,4,여행,지출,2303,37905
2021,2,23,쇼핑,지출,3149,34756
2021,8,15,여행,지출,8670,26086
2023,4,28,MT,수입,8858,34944
2021,5,20,MT,수입,7611,42555
2021,12,12,체육대회,지출,5746,36809
2022,8,23,MT,수입,2787,39596
2022,1,7,여행,지출,4537,35059
2021,3,22,체육대회,수입,6704,41763
2021,8,31,식사,지출,9145,32618
2020,1,14,쇼핑,지출,2160,30458
2023,2,14,식사,지출,4538,25920
2021,12,28,식사,수입,1449,27369
2023,5,13,식사,지출,5371,21998
2022,9,16,MT,지출,1714,20284
2023,2,24,여행,수입,4930,25214
2023,5,17,쇼핑,수입,7953,33167
2023,5,24,체육대회,수입,3822,36989
2022,6,21,쇼핑,수입,8109,45098
2021,6,2,식사,수입,7270,52368
2022,6,7,MT,수입,2443,54811
2023,5,26,MT,수입,6120,60931
2021,7,28,식사,지출,8534,52397
2022,8,2,여행,수입,3891,56288
2021,9,10,식사,수입,1807,58095
2020,5,13,쇼핑,지출,2079,56016
2023,6,17,식사,지출,6945,49071
2023,12,7,식사,지출,7794,41277
2023,10,27,MT,지출,5920,35357
2021,4,3,식사,지출,3348,32009
2021,11,9,여행,수입,8393,40402
2023,11,26,여행,지출,2539,37863
2022,5,4,식사,수입,5051,42914
2022,11,28,여행,수입,1637,44551
2020,6,16,여행,수입,6161,50712
2022,10,20,식사,수입,6491,57203
2020,3,15,쇼핑,수입,3596,60799
2020,6,23,체육대회,지출,5198,55601
2023,7,17,여행,수입,8454,64055
2022,8,19,여행,지출,6021,58034
2023,3,26,여행,수입,7495,65529
2023,10,22,식사,수입,4070,69599
2021,11,22,MT,수입,5254,74853
2022,5,23,쇼핑,지출,6890,67963
2022,9,18,여행,지출,8816,59147
2022,10,16,쇼핑,수입,9051,68198
2020,11,18,식사,수입,3823,72021
2021,8,28,MT,수입,5867,77888
2020,6,7,쇼핑,지출,3616,74272
2023,5,21,쇼핑,지출,4504,69768
2021,3,9,식사,지출,2156,67612
2022,10,8,여행,수입,3901,71513
2021,3,3,쇼핑,지출,2695,68818
2021,10,8,MT,수입,4251,73069
2022,1,3,MT,지출,4388,68681
2021,11,29,여행,수입,5116,73797
2022,2,22,MT,지출,6420,67377
2021,10,12,MT,지출,4363,63014
2021,6,19,쇼핑,수입,3996,67010
2022,3,7,MT,지출,9966,57044
2021,8,1,쇼핑,지출,6429,50615
2021,8,2,식사,지출,8945,41670
2023,7,12,체육대회,지출,3562,38108
2020,10,16,식사,수입,6373,44481
2020,2,24,체육대회,지출,6513,37968
2023,11,23,쇼핑,수입,3467,41435
2023,12,11,MT,수입,4895,46330
2020,11,10,식사,지출,9193,37137
2023,8,2,식사,수입,4435,41572
2021,2,2,식사,지출,8798,32774
2023,1,1,쇼핑,지출,5942,26832
2022,8,4,식사,지출,7955,18877
2020,9,8,MT,수입,8460,27337
2021,5,19,MT,수입,2974,30311
2020,1,6,쇼핑,지출,6249,24062
2020,5,26,MT,수입,5266,29328
2023,5,16,여행,지출,8101,21227
2023,6,11,체육대회,수입,2750,23977
2021,11,8,쇼핑,수입,8630,32607
2020,5,13,쇼핑,수입,2466,35073
2021,4,14,여행,지출,6760,28313
2020,4,2,식사,지출,1578,26735
2022,6,15,여행,지출,1786,24949
2020,3,9,식사,지출,8534,16415
2020,4,5,체육대회,수입,8747,25162
2020,7,10,체육대회,수입,9058,34220
2021,6,2,체육대회,수입,3122,37342
2022,9,23,MT,수입,5762,43104
2020,12,23,체육대회,수입,5241,48345
2020,3,19,MT,지출,9625,38720
2023,3,6,여행,수입,4016,42736
2020,4,6,MT,수입,7135,49871
2023,7,22,체육대회,수입,2524,52395
2022,8,25,체육대회,지출,6066,46329
2020,4,29,MT,지출,3559,42770
2022,3,23,체육대회,지출,8934,33836
2021,2,3,여행,수입,9031,42867
2020,5,30,식사,지출,3666,39201
2021,7,22,체육대회,수입,5141,44342
2023,2,9,쇼핑,지출,1384,42958
2020,3,19,여행,수입,6263,49221
2021,9,15,식사,수입,5941,55162
2023,7,13,체육대회,지출,4189,50973
2023,4,21,여행,수입,3646,54619
2021,1,27,쇼핑,지출,5431,49188
2023,6,7,쇼핑,지출,1475,47713
2021,5,18,여행,수입,5607,53320
2023,3,20,체육대회,수입,8688,62008
2020,6,3,식사,지출,9286,52722
2021,1,22,체육대회,지출,8069,44653
2020,6,16,MT,수입,4179,48832
2020,6,13,여행,수입,7694,56526
2021,9,2,쇼핑,수입,4604,61130
2021,12,30,식사,지출,2863,58267
2021,2,9,MT,지출,8566,49701
2023,4,12,체육대회,수입,8718,58419
2022,12,10,식사,지출,2117,56302
2020,10,25,여행,수입,4920,61222
2020,7,15,MT,지출,1013,60209
2023,9,10,MT,수입,4870,65079
2023,4,10,쇼핑,지출,4586,60493
2022,2,16,식사,지출,7548,52945
2020,12,17,쇼핑,수입,3822,56767
2022,8,30,식사,지출,9062,47705
2023,10,14,쇼핑,수입,5225,52930
2022,7,25,체육대회,수입,7244,60174
2022,10,25,쇼핑,지출,4658,55516
2022,3,30,MT,지출,5517,49999
2023,7,18,식사,수입,9976,59975
2020,9,26,여행,지출,6621,53354
2022,2,19,식사,수입,5741,59095
2022,11,14,MT,수입,9245,68340
2023,6,21,식사,수입,2022,70362
2023,3,8,여행,지출,3022,67340
2021,8,8,쇼핑,지출,9453,57887
2022,11,10,여행,지출,2709,55178
2020,4,16,쇼핑,수입,1452,56630
2023,6,5,여행,지출,9090,47540
2023,8,31,MT,수입,6503,54043
2021,9,29,체육대회,지출,4633,49410
2021,9,1,쇼핑,수입,2918,52328
2023,2,4,쇼핑,지출,6494,45834
2022,1,9,여행,지출,6413,39421
2023,12,18,여행,지출,8071,31350
2021,7,17,여행,수입,3957,35307
2021,7,24,쇼핑,수입,6748,42055
2022,4,18,여행,지출,1011,41044
2020,9,26,체육대회,수입,8973,50017
2021,2,4,체육대회,수입,2151,52168
2020,6,2,MT,수입,1411,53579
2023,1,5,MT,수입,9867,63446
2023,8,22,여행,수입,2989,66435
2022,12,7,쇼핑,수입,8220,74655
2020,12,28,쇼핑,지출,4666,69989
2022,9,22,쇼핑,수입,1517,71506
2021,1,6,MT,지출,8171,63335
2020,11,8,여행,지출,2665,60670
2020,1,9,식사,지출,7866,52804
2021,10,13,체육대회,지출,2139,50665
2020,8,5,체육대회,지출,4136,46529
2023,7,18,식사,수입,9866,56395
2021,7,5,MT,수입,7473,63868
2023,2,11,체육대회,수입,9628,73496
2021,10,4,여행,수입,7576,81072
2020,1,31,MT,지출,7175,73897
2021,1,13,여행,수입,7469,81366
2021,9,28,쇼핑,수입,9712,91078
2023,12,13,여행,지출,8120,82958
2021,11,19,체육대회,수입,3973,86931
2022,7,5,쇼핑,수입,1797,88728
2022,7,11,체육대회,수입,9352,98080
2023,12,3,식사,수입,3689,101769
2021,8,10,여행,수입,6368,108137
2021,4,19,체육대회,수입,8197,116334
2020,8,10,쇼핑,수입,6790,123124
2020,10,7,쇼핑,수입,2086,125210
2021,7,3,쇼핑,지출,1128,124082
2022,3,18,MT,지출,9067,115015
2021,11,2,여행,수입,6007,121022
2023,8,2,여행,지출,3816,117206
2020,6,22,여행,수입,1159,118365
2020,8,19,식사,수입,4832,123197
2022,2,4,식사,지출,1798,121399
2020,12,4,MT,지출,1799,119600
2021,9,7,식사,지출,8227,111373
2020,9,26,여행,수입,2637,114010
2022,6,4,여행,지출,2850,111160
2023,7,22,여행,지출,3696,107464
2020,4,13,식사,지출,4844,102620
2022,8,27,쇼핑,지출,2526,100094
2023,1,15,체육대회,지출,9014,91080
2021,7,4,MT,지출,1080,90000
2020,5,21,체육대회,수입,4695,94695
2023,4,5,식사,수입,9991,104686
2023,4,15,MT,지출,1588,103098
2020,3,19,식사,수입,6896,109994
2020,2,28,쇼핑,수입,4217,114211
2021,6,8,식사,수입,6442,120653
2022,1,13,쇼핑,지출,1507,119146
2020,4,8,MT,지출,4343,114803
2023,1,29,쇼핑,지출,6620,108183
2020,6,27,식사,수입,5858,114041
2021,2,5,체육대회,지출,8005,106036
2020,3,1,식사,지출,7093,98943
2023,10,24,체육대회,지출,7879,91064
2022,5,5,식사,수입,4748,95812
2023,12,18,체육대회,수입,6034,101846
2022,12,2,식사,지출,4679,97167
2022,10,4,MT,수입,2791,99958
2021,5,9,식사,지출,9046,90912
2021,4,5,식사,수입,8721,99633
2021,12,25,식사,지출,2828,96805
2020,5,4,쇼핑,지출,5877,90928
2021,2,22,쇼핑,지출,2705,88223
2022,4,27,식사,지출,8903,79320
2022,8,21,식사,수입,8182,87502
2023,2,1,MT,지출,2870,84632
2021,6,7,MT,수입,5089,89721
2023,3,22,여행,수입,8444,98165
2020,11,17,MT,수입,4666,102831
2022,3,19,체육대회,지출,1361,101470
2020,8,29,쇼핑,수입,5781,107251
2020,11,5,체육대회,수입,9467,116718
2021,12,19,여행,수입,1492,118210
2020,1,14,MT,지출,1515,116695
2022,9,5,쇼핑,지출,5126,111569
2022,11,16,MT,수입,8414,119983
2021,4,7,식사,수입,6834,126817
2022,3,23,MT,수입,5051,131868
2023,5,6,체육대회,지출,9913,121955
2020,10,18,식사,지출,2724,119231
2023,9,11,여행,지출,5313,113918
2021,5,8,쇼핑,지출,9184,104734
2020,1,6,체육대회,지출,9620,95114
2022,2,11,체육대회,지출,4908,90206
2023,4,16,식사,수입,7141,97347
2023,6,2,체육대회,지출,4578,92769
2023,12,29,MT,지출,5218,87551
2021,11,21,체육대회,지출,3899,83652
2023,1,26,여행,수입,7753,91405
2020,6,26,MT,수입,3353,94758
2023,3,10,체육대회,수입,7466,102224
2020,6,29,체육대회,수입,9560,111784
2020,9,21,식사,수입,5300,117084
2020,6,5,쇼핑,지출,9137,107947
2021,1,23,식사,수입,3097,111044
2023,11,21,식사,수입,5023,116067
2021,11,21,MT,수입,5275,121342
2021,2,8,식사,수입,1244,122586
2021,4,12,여행,수입,5020,127606
2022,10,30,식사,수입,6295,133901
2020,12,2,여행,수입,3906,137807
2022,2,20,여행,수입,3712,141519
2023,10,23,여행,수입,9566,151085
2022,7,28,체육대회,수입,1974,153059
2020,10,3,식사,지출,3315,149744
2023,7,25,체육대회,수입,7740,157484
2020,7,31,쇼핑,지출,4765,152719
2022,9,5,여행,지출,3799,148920
2023,11,9,식사,지출,7780,141140
2022,2,27,식사,지출,4383,136757
2023,12,6,식사,수입,5349,142106
2020,4,16,식사,지출,2750,139356
2021,4,2,체육대회,수입,4518,143874
2023,11,15,쇼핑,수입,7950,151824
2021,2,17,식사,수입,6046,157870
2021,1,2,여행,지출,4709,153161
2022,11,11,여행,지출,3122,150039
2023,5,31,식사,지출,9454,140585
2021,10,2,식사,수입,1127,141712
2022,11,6,MT,지출,7171,134541
2021,12,31,식사,수입,9339,143880
2020,1,4,여행,지출,4402,139478
2023,12,28,쇼핑,지출,7543,131935
2023,3,29,식사,지출,9783,122152
2021,3,28,여행,지출,2846,119306
2021,12,12,체육대회,수입,7874,127180
2022,5,19,식사,수입,1510,128690
2021,7,9,체육대회,수입,8290,136980
2021,7,8,MT,수입,7938,144918
2022,11,20,여행,수입,8410,153328
2020,11,8,여행,수입,9221,162549
2021,2,11,체육대회,수입,8947,171496
2020,1,14,체육대회,지출,1614,169882
2022,11,13,MT,수입,8314,178196
2021,7,15,여행,지출,5090,173106
2020,10,24,여행,수입,9994,183100
2021,12,21,체육대회,지출,4405,178695
2022,6,12,여행,지출,5950,172745
2022,7,5,MT,수입,1499,174244
2023,10,11,MT,지출,8249,165995
2022,11,18,쇼핑,지출,7361,158634
2021,6,20,쇼핑,수입,2273,160907
2020,7,4,MT,지출,7656,153251
2020,1,24,MT,지출,3193,150058
2020,2,18,MT,수입,6192,156250
2020,6,2,체육대회,수입,9009,165259
2020,2,20,체육대회,지출,1686,163573
2020,7,25,식사,수입,6982,170555
2020,3,6,체육대회,수입,7157,177712
2022,11,19,여행,수입,9404,187116
2021,10,21,여행,수입,5040,192156
2023,7,29,쇼핑,수입,3958,196114
2020,4,7,여행,지출,8817,187297
2022,12,5,MT,수입,1094,188391
2022,3,31,식사,지출,5242,183149
2020,2,5,식사,지출,6042,177107
2021,3,10,체육대회,지출,5066,172041
2020,7,31,쇼핑,수입,1187,173228
2020,2,1,체육대회,지출,7638,165590
2022,7,21,체육대회,수입,5179,170769
2022,5,14,MT,지출,6678,164091
2023,10,18,쇼핑,수입,6082,170173
2022,7,20,식사,수입,3958,174131
2023,5,19,MT,수입,2759,176890
2021,10,18,쇼핑,수입,6499,183389
2021,9,13,체육대회,수입,3517,186906
2021,10,31,쇼핑,수입,5549,192455
2023,8,27,MT,수입,1909,194364
2020,9,26,MT,지출,8063,186301
2020,11,19,쇼핑,지출,4191,182110
2022,2,10,쇼핑,수입,4581,186691
2021,11,2,쇼핑,수입,1463,188154
2022,2,4,쇼핑,지출,7839,180315
2020,9,8,MT,수입,8449,188764
2023,9,29,체육대회,수입,6109,194873
2023,3,11,체육대회,지출,3191,191682
2023,3,7,식사,지출,8775,182907
2020,12,27,여행,지출,7002,175905
2021,1,6,식사,지출,7415,168490
2022,8,14,여행,수입,4338,172828
2020,10,25,식사,지출,6902,165926
2021,8,17,체육대회,수입,6879,172805
2023,6,24,식사,수입,6093,178898
2023,10,17,여행,수입,5801,184699
2021,5,16,쇼핑,지출,7421,177278
2020,7,22,여행,지출,4682,172596
2020,8,8,여행,지출,5600,166996
2023,9,24,MT,수입,4101,171097
2023,8,27,여행,수입,2227,173324
2023,4,6,체육대회,지출,6540,166784
2020,9,17,식사,지출,2453,164331
2023,12,11,여행,지출,1106,163225
2020,6,19,여행,수입,5322,168547
2022,1,31,쇼핑,수입,1514,170061
2022,11,4,체육대회,수입,8039,178100
2022,12,15,식사,지출,5867,172233
2023,9,4,쇼핑,지출,1603,170630
2023,3,29,체육대회,지출,7306,163324
2021,9,17,체육대회,지출,2283,161041
2021,1,27,MT,지출,2849,158192
2021,4,27,MT,지출,7872,150320
2021,3,9,MT,수입,4934,155254
2020,7,5,쇼핑,수입,2717,157971
2021,12,2,쇼핑,수입,3879,161850
2023,7,2,MT,지출,3613,158237
2020,7,26,식사,수입,6879,165116
2022,11,20,여행,수입,3428,168544
2020,11,12,쇼핑,지출,1662,166882
2020,6,1,MT,수입,9886,176768
2022,3,28,쇼핑,수입,3577,180345
2021,5,15,체육대회,수입,2775,183120
2020,9,14,MT,수입,2821,185941
2021,6,13,MT,수입,2763,188704
2023,2,27,MT,지출,4164,184540
2023,5,28,쇼핑,수입,6477,191017
2023,2,9,여행,수입,6272,197289
2021,5,24,체육대회,수입,7441,204730
2020,8,23,식사,지출,3942,200788
2020,10,11,체육대회,수입,3143,203931
2021,8,8,쇼핑,지출,9527,194404
2020,10,31,체육대회,수입,1436,195840
2022,8,8,MT,지출,6828,189012
2022,2,28,쇼핑,수입,5377,194389
2023,8,28,쇼핑,수입,5822,200211
2022,9,2,체육대회,지출,7022,193189
2023,9,21,식사,수입,3082,196271
2021,12,7,체육대회,지출,4826,191445
2022,1,3,여행,수입,1300,192745
2021,7,3,쇼핑,지출,6995,185750
2023,9,2,식사,지출,4054,181696
2021,6,10,체육대회,수입,7696,189392
2023,1,9,체육대회,지출,4051,185341
2021,3,12,체육대회,지출,9632,175709
2023,3,7,여행,지출,4865,170844
2020,2,7,식사,지출,8159,162685
2020,9,7,쇼핑,수입,1650,164335
2023,9,30,체육대회,지출,3697,160638
2021,3,5,MT,지출,8777,151861
2021,4,7,MT,지출,6008,145853
2020,4,4,쇼핑,수입,5129,150982
2022,10,2,식사,지출,6157,144825
2023,9,23,식사,지출,9022,135803
2021,8,12,쇼핑,지출,1659,134144
2021,9,20,체육대회,지출,1132,133012
2023,5,16,식사,지출,4646,128366
2020,1,4,식사,지출,5560,122806
2020,4,21,쇼핑,지출,2146,120660
2021,7,4,MT,수입,2686,123346
2021,12,18,체육대회,수입,7449,130795
2022,3,4,쇼핑,수입,3245,134040
2020,2,5,체육대회,지출,8782,125258
2023,10,15,쇼핑,지출,9851,115407
2021,3,2,여행,지출,5119,110288
2023,1,8,쇼핑,지출,1798,108490
2023,1,8,쇼핑,지출,1044,107446
2023,6,19,식사,지출,5554,101892
2022,6,30,체육대회,지출,4721,97171
2020,2,1,MT,지출,7168,90003
2023,7,15,체육대회,수입,9081,99084
2020,2,4,체육대회,수입,6115,105199
2020,2,5,여행,수입,4375,109574
2020,4,24,쇼핑,수입,5223,114797
2021,2,25,체육대회,지출,5255,109542
2021,2,21,MT,지출,6714,102828
2022,9,18,체육대회,지출,6281,96547
2023,6,21,식사,지출,2646,93901
2020,1,14,식사,지출,3919,89982
2020,9,6,MT,지출,1686,88296
2020,7,27,MT,수입,3821,92117
2020,7,12,식사,수입,5733,97850
2022,8,7,여행,지출,5812,92038
2023,2,6,체육대회,수입,6354,98392
2020,10,20,식사,지출,4346,94046
2022,8,17,식사,수입,6306,100352
2023,11,28,쇼핑,수입,3849,104201
2021,8,30,여행,수입,9972,114173
2022,12,11,MT,지출,9416,104757
2020,5,31,MT,수입,7187,111944
2023,3,22,식사,수입,5926,117870
2020,12,13,식사,수입,4133,122003
2023,9,17,MT,지출,2000,120003
2020,12,17,여행,수입,6920,126923
2023,11,27,여행,지출,4387,122536
2020,5,19,쇼핑,지출,1954,120582
2023,1,10,MT,수입,2374,122956
2023,8,21,MT,지출,1190,121766
2022,1,17,체육대회,지출,7967,113799
2020,1,5,쇼핑,수입,5498,119297
2020,8,4,여행,지출,9862,109435
2023,2,7,체육대회,수입,3327,112762
2022,1,1,쇼핑,수입,6745,119507
2020,6,20,쇼핑,지출,5449,114058
2021,10,4,식사,지출,7599,106459
2022,7,31,체육대회,지출,1494,104965
2020,12,1,MT,지출,3195,101770
2022,12,18,식사,수입,3231,105001
2020,5,13,여행,수입,2487,107488
2020,3,14,쇼핑,수입,8802,116290
2021,10,7,쇼핑,지출,9530,106760
2023,6,10,식사,지출,6557,100203
2020,8,5,쇼핑,수입,3257,103460
2023,4,23,여행,수입,3075,106535
2022,9,7,MT,지출,2466,104069
2020,10,12,여행,수입,1314,105383
2021,11,3,체육대회,지출,9748,95635
2020,10,30,체육대회,지출,3717,91918
2021,2,11,쇼핑,수입,9863,101781
2021,8,1,체육대회,지출,7409,94372
2022,1,12,식사,지출,2514,91858
2021,2,11,MT,지출,8965,82893
2021,8,6,식사,지출,9381,73512
2022,4,29,쇼핑,지출,3591,69921
2022,4,13,여행,수입,3667,73588
2021,5,1,체육대회,지출,2570,71018
2023,8,9,쇼핑,수입,6301,77319
2021,4,17,여행,수입,8950,86269
2020,12,4,체육대회,지출,4063,82206
2020,2,28,식사,수입,1229,83435
2022,3,11,쇼핑,수입,7467,90902
2023,11,9,쇼핑,지출,7388,83514
2021,5,26,체육대회,수입,9995,93509
2023,7,7,여행,수입,9842,103351
2022,8,5,MT,지출,2868,100483
2020,9,18,식사,지출,8154,92329
2022,6,20,식사,지출,8417,83912
2023,6,9,체육대회,수입,4128,88040
2022,3,28,여행,수입,8704,96744
2023,3,8,체육대회,수입,5018,101762
2022,3,21,MT,수입,8915,110677
2022,12,5,식사,지출,6907,103770
2021,10,7,쇼핑,수입,9020,112790
2020,3,14,여행,지출,9764,103026
2023,5,1,여행,지출,5142,97884
2021,7,5,쇼핑,지출,3281,94603
2023,4,20,식사,수입,7207,101810
2021,10,16,MT,지출,2807,99003
2023,6,28,식사,수입,1776,100779
2020,12,3,체육대회,수입,2450,103229
2023,9,16,체육대회,지출,3570,99659
2023,12,1,식사,지출,9029,90630
2022,6,1,체육대회,수입,8788,99418
2023,1,19,체육대회,수입,4082,103500
2020,2,18,여행,지출,5801,97699
2023,9,23,식사,지출,1491,96208
2023,2,8,쇼핑,지출,9079,87129
2022,6,15,체육대회,지출,6736,80393
2020,4,5,MT,수입,3707,84100
2021,12,25,체육대회,수입,6472,90572
2023,3,13,체육대회,지출,6692,83880
2022,2,25,체육대회,수입,5070,88950
2020,7,28,체육대회,수입,1130,90080
2022,6,13,식사,수입,9313,99393
2020,8,1,식사,지출,3150,96243
2020,7,18,체육대회,수입,5871,102114
2023,7,24,체육대회,지출,5526,96588
2020,3,24,식사,지출,7156,89432
2022,11,2,식사,수입,9103,98535
2022,12,12,체육대회,지출,3164,95371
2020,3,9,MT,지출,9131,86240
2020,5,10,식사,수입,3431,89671
2021,8,8,쇼핑,지출,7267,82404
2023,4,5,식사,지출,5888,76516
2020,6,11,쇼핑,지출,1709,74807
2022,2,9,여행,수입,2609,77416
2020,10,2,여행,지출,4782,72634
2020,6,8,쇼핑,지출,5667,66967
2020,3,20,체육대회,수입,7908,74875
2022,9,2,쇼핑,수입,2214,77089
2022,3,1,쇼핑,수입,4732,81821
2023,10,17,쇼핑,수입,9561,91382
2022,11,7,식사,수입,1053,92435
2023,4,21,체육대회,지출,7638,84797
2020,1,11,식사,지출,5680,79117
2022,3,15,MT,지출,9347,69770
2022,3,19,식사,수입,9513,79283
2020,6,28,체육대회,지출,7142,72141
2021,1,14,체육대회,지출,7695,64446
2022,11,13,여행,수입,4657,69103
2022,8,31,체육대회,수입,5328,74431
2021,10,5,MT,수입,9565,83996
2020,3,19,MT,지출,8883,75113
2022,5,10,MT,수입,1022,76135
2021,1,10,MT,수입,5147,81282
2020,6,4,MT,수입,7812,89094
2021,10,8,여행,지출,8786,80308
2021,1,15,MT,수입,2884,83192
2023,1,10,MT,수입,9769,92961
2020,7,31,MT,지출,2068,90893
2020,1,7,식사,수입,4354,95247
2022,12,18,쇼핑,지출,3574,91673
2021,5,24,여행,수입,1167,92840
2022,10,13,식사,지출,6114,86726
2021,10,6,쇼핑,지출,9531,77195
2023,3,19,MT,수입,8294,85489
2021,1,20,MT,지출,7975,77514
2022,10,7,MT,지출,1897,75617
2023,1,5,체육대회,지출,2946,72671
2021,1,25,여행,수입,4004,76675
2020,6,17,식사,지출,1793,74882
2021,9,17,식사,지출,1407,73475
2022,7,1,식사,지출,5156,68319
2022,3,12,여행,수입,9659,77978
2023,3,24,MT,수입,3202,81180
2021,1,11,체육대회,지출,7493,73687
2023,2,23,식사,수입,9973,83660
2021,6,14,식사,수입,3598,87258
2022,12,13,체육대회,지출,7186,80072
2023,2,1,쇼핑,지출,7479,72593
2020,12,14,여행,지출,6803,65790
2020,7,13,MT,지출,6077,59713
2021,6,2,쇼핑,지출,4498,55215
2020,6,25,식사,수입,1105,56320
2023,2,15,체육대회,수입,6210,62530
2021,9,7,MT,지출,9897,52633
2023,5,1,체육대회,지출,9414,43219
2020,7,8,여행,지출,4499,38720
2021,12,14,식사,수입,2028,40748
2021,5,17,체육대회,지출,1851,38897
2021,5,31,여행,지출,5521,33376
2020,1,3,체육대회,지출,3561,29815
2023,6,21,체육대회,수입,1804,31619
2020,2,9,쇼핑,지출,5803,25816
2023,9,11,MT,수입,6277,32093
2022,10,14,체육대회,수입,9683,41776
2023,3,8,쇼핑,수입,1364,43140
2023,11,19,식사,지출,4036,39104
2021,2,4,쇼핑,지출,9957,29147
2021,4,30,식사,수입,8787,37934
2022,2,3,체육대회,수입,2962,40896
2023,9,25,여행,지출,1986,38910
2023,2,9,쇼핑,수입,6484,45394
2020,3,23,여행,수입,1309,46703
2023,4,14,식사,지출,1666,45037
2021,11,3,체육대회,수입,2382,47419
2020,3,20,체육대회,지출,6430,40989
2023,6,4,여행,수입,3621,44610
2020,2,22,여행,지출,4567,40043
2021,11,16,여행,지출,8032,32011
2021,5,24,여행,지출,9926,22085
2023,9,24,MT,지출,8031,14054
2021,1,21,식사,지출,6742,7312
2022,2,10,식사,수입,4701,12013
2023,9,26,여행,지출,3308,8705
2022,12,25,MT,지출,7635,1070
2020,9,13,쇼핑,지출,9844,-8774
2022,12,7,식사,지출,5155,-13929
2022,3,19,체육대회,수입,2860,-11069
2022,12,3,체육대회,지출,7859,-18928
2020,2,3,여행,수입,3858,-15070
2021,12,1,체육대회,지출,1047,-16117
2023,9,12,체육대회,지출,8160,-24277
2020,3,11,체육대회,수입,4287,-19990
2022,8,14,MT,지출,8063,-28053
2021,2,6,체육대회,수입,1502,-26551
2022,10,21,MT,수입,6297,-20254
2020,11,28,여행,수입,6819,-13435
2022,2,11,여행,수입,2271,-11164
2021,9,7,여행,지출,4803,-15967
2021,1,8,쇼핑,수입,6715,-9252
2023,6,10,식사,수입,6885,-2367
2020,2,29,식사,수입,2560,193
2021,12,29,식사,지출,1779,-1586
2022,9,20,쇼핑,지출,3298,-4884
2020,5,24,체육대회,수입,5345,461
2022,4,5,쇼핑,수입,8186,8647
2023,2,1,MT,수입,9848,18495
2022,5,28,쇼핑,지출,3822,14673
2023,4,2,체육대회,수입,3143,17816
2022,5,1,쇼핑,수입,3496,21312
2021,1,22,MT,수입,5254,26566
2021,2,26,식사,지출,1191,25375
2021,10,9,체육대회,지출,9724,15651
2022,2,10,체육대회,수입,1665,17316
2022,4,13,체육대회,지출,6341,10975
2023,12,22,체육대회,수입,2340,13315
2022,5,3,여행,지출,7263,6052
2022,12,28,체육대회,수입,2883,8935
2023,9,23,식사,지출,2205,6730
2022,9,28,MT,지출,4905,1825
2022,8,8,식사,수입,6857,8682
2021,6,22,MT,지출,7282,1400
2020,12,28,여행,지출,3057,-1657
2021,5,23,MT,수입,3402,1745
2021,1,9,MT,수입,4534,6279
2021,7,7,MT,수입,2497,8776
2022,2,20,식사,지출,3527,5249
2020,7,9,식사,지출,7233,-1984
2020,5,24,MT,수입,9663,7679
2020,8,1,MT,수입,7172,14851
2023,5,17,체육대회,지출,7977,6874
2020,2,29,여행,수입,6746,13620
2020,4,4,MT,수입,7201,20821
2022,5,17,식사,수입,5390,26211
2022,6,21,여행,수입,3963,30174
2020,7,15,체육대회,지출,2431,27743
2022,5,20,체육대회,지출,6042,21701
2023,6,22,여행,수입,2524,24225
2021,8,26,MT,지출,9544,14681
2020,5,11,식사,지출,5513,9168
2023,10,23,식사,수입,6485,15653
2020,1,3,여행,수입,2930,18583
2020,10,20,식사,수입,4993,23576
2022,6,21,여행,지출,3048,20528
2022,1,27,여행,지출,5294,15234
2021,4,21,MT,지출,2932,12302
2022,7,17,식사,지출,7608,4694
2021,6,14,MT,지출,1298,3396
2023,4,5,쇼핑,수입,8059,11455
2023,6,22,체육대회,수입,1863,13318
2021,6,5,쇼핑,수입,7482,20800
2023,11,25,쇼핑,수입,5660,26460
2021,3,28,여행,수입,2252,28712
2022,9,2,체육대회,지출,3265,25447
2023,5,13,식사,수입,8943,34390
2021,2,26,쇼핑,수입,2819,37209
2021,12,9,체육대회,수입,9194,46403
2021,11,1,여행,지출,2897,43506
2022,7,9,MT,지출,7203,36303
2020,1,2,체육대회,수입,1008,37311
2023,12,15,MT,지출,1579,35732
2023,10,5,쇼핑,수입,8357,44089
2023,2,1,MT,지출,6906,37183
2022,4,18,MT,지출,9985,27198
2021,2,25,식사,지출,4658,22540
2020,1,24,MT,지출,1958,20582
2021,1,16,체육대회,수입,9153,29735
2020,3,16,쇼핑,지출,9776,19959
2022,5,8,MT,지출,5556,14403
2020,9,27,체육대회,수입,2675,17078
2021,10,3,식사,지출,7351,9727
2023,5,10,체육대회,수입,7431,17158
2022,1,23,여행,수입,7171,24329
2020,3,15,MT,지출,8786,15543
2020,3,15,여행,지출,4708,10835
2023,10,14,체육대회,수입,9417,20252
2023,7,5,여행,지출,9736,10516
2020,8,26,쇼핑,수입,7793,18309
2022,3,1,MT,수입,9506,27815
2023,1,26,쇼핑,수입,5189,33004
2020,8,18,체육대회,지출,4872,28132
2023,7,18,식사,수입,9966,38098
2021,9,28,여행,지출,8379,29719
2020,5,30,체육대회,수입,7483,37202
2023,12,25,쇼핑,지출,8039,29163
2021,7,31,쇼핑,지출,7145,22018
2022,11,16,체육대회,지출,2591,19427
2020,9,18,쇼핑,지출,3910,15517
2022,9,21,식사,지출,7872,7645
2023,1,30,MT,지출,9316,-1671
2022,6,24,식사,수입,2335,664
2023,8,10,MT,수입,7640,8304
2022,8,1,쇼핑,수입,4913,13217
2022,12,28,식사,수입,6454,19671
2023,12,3,식사,지출,2769,16902
2022,10,15,체육대회,수입,1251,18153
2023,4,28,여행,수입,6103,24256
2022,3,4,MT,지출,7295,16961
2020,4,15,여행,지출,8152,8809
2023,2,13,체육대회,수입,8830,17639
2023,5,16,식사,지출,9096,8543
2022,1,5,쇼핑,수입,3125,11668
2023,7,15,여행,지출,3335,8333
2022,12,23,여행,수입,8701,17034
2022,4,9,쇼핑,지출,9362,7672
2020,5,6,여행,수입,3391,11063
2021,9,11,쇼핑,지출,3063,8000
2023,8,2,식사,지출,6700,1300
2021,7,7,MT,수입,1423,2723
2022,5,21,여행,지출,5373,-2650
2020,1,4,체육대회,지출,2154,-4804
2022,4,25,여행,지출,5988,-10792
2023,10,15,MT,지출,8025,-18817
2020,11,12,체육대회,지출,7310,-26127
2022,9,22,MT,수입,8200,-17927
2020,2,15,쇼핑,수입,4001,-13926
2020,4,9,식사,수입,3789,-10137
2023,10,30,여행,지출,2716,-12853
2022,10,10,쇼핑,지출,1128,-13981
2022,1,15,쇼핑,수입,3996,-9985
2020,7,19,식사,지출,8185,-18170
2021,3,22,쇼핑,수입,4720,-13450
2023,6,10,MT,수입,8518,-4932
2021,8,10,쇼핑,수입,4201,-731
2023,10,26,여행,수입,2637,1906
2020,5,27,여행,수입,4457,6363
2022,10,23,체육대회,지출,2497,3866
2021,4,29,쇼핑,지출,9092,-5226
2020,11,27,체육대회,수입,5013,-213
2023,10,24,여행,지출,9952,-10165
2020,12,16,식사,수입,6311,-3854
2021,11,12,MT,수입,9302,5448
2021,10,24,쇼핑,수입,4742,10190
2021,11,10,여행,지출,3934,6256
2020,12,1,쇼핑,수입,2992,9248
2023,3,10,체육대회,수입,3020,12268
2021,1,10,식사,수입,3830,16098
2021,5,1,체육대회,지출,5049,11049
2021,4,18,MT,수입,2417,13466
2021,1,26,체육대회,지출,6739,6727
2023,5,18,체육대회,지출,7066,-339
2020,6,27,체육대회,지출,4139,-4478
2020,7,26,식사,수입,6234,1756
2020,4,29,쇼핑,수입,5712,7468
2021,12,1,체육대회,지출,3029,4439
2021,10,9,여행,수입,2722,7161
2021,4,10,MT,수입,1035,8196
2021,1,3,체육대회,지출,6536,1660
2022,9,24,식사,지출,3925,-2265
2023,12,25,식사,수입,9320,7055
2020,4,15,MT,수입,7330,14385
2023,2,12,식사,수입,5383,19768
2022,4,18,쇼핑,지출,8651,11117
2021,12,17,식사,수입,3751,14868
2020,10,24,체육대회,지출,8428,6440
2022,8,31,MT,수입,8645,15085
2021,12,9,식사,지출,4864,10221
2022,11,27,MT,지출,6247,3974
2023,10,5,쇼핑,수입,9816,13790
2020,3,31,체육대회,지출,7422,6368
2020,7,20,식사,지출,3702,2666
2020,10,21,MT,수입,8429,11095
2020,9,18,여행,수입,3675,14770
2023,3,28,MT,지출,7335,7435
2020,11,18,식사,수입,9516,16951
2023,10,17,여행,수입,2868,19819
2021,4,26,체육대회,지출,1528,18291
2022,4,19,MT,지출,1227,17064
2021,5,5,식사,수입,6655,23719
2021,9,25,MT,수입,8911,32630
2023,8,10,식사,수입,8261,40891
2020,7,18,여행,지출,5970,34921
2021,9,25,쇼핑,지출,1195,33726
2020,12,17,체육대회,수입,1589,35315
2020,12,6,식사,수입,4438,39753
2020,7,18,체육대회,수입,8276,48029
2022,2,3,쇼핑,수입,4172,52201
2022,10,9,체육대회,수입,5725,57926
2022,3,29,식사,지출,7519,50407
2022,4,12,여행,수입,4479,54886
2022,1,2,여행,수입,9930,64816
2021,12,9,체육대회,수입,4358,69174
2022,6,7,여행,수입,7046,76220
2020,9,29,식사,지출,8456,67764
2021,1,9,식사,지출,2251,65513
2020,8,10,MT,수입,3987,69500
2023,2,25,체육대회,지출,1134,68366
2020,9,2,여행,수입,9534,77900
2021,9,1,MT,지출,2611,75289
2023,5,9,여행,수입,3273,78562
2023,6,9,체육대회,수입,7985,86547
2020,11,24,여행,수입,3422,89969
2021,4,7,쇼핑,지출,3879,86090
2023,12,25,여행,수입,1266,87356
2021,1,27,여행,지출,9567,77789
2020,6,4,MT,지출,3349,74440
2023,7,11,쇼핑,지출,4484,69956
2021,8,21,MT,수입,3233,73189
2021,9,21,쇼핑,지출,3091,70098
2023,10,31,식사,수입,3257,73355
2020,8,10,체육대회,수입,6994,80349
2020,10,6,MT,지출,9474,70875
2022,12,19,여행,수입,2229,73104
2021,6,4,여행,지출,2241,70863
2020,4,14,쇼핑,수입,6903,77766
2020,7,4,식사,지출,2282,75484
2021,8,6,체육대회,수입,6514,81998
2020,10,18,체육대회,지출,9388,72610
2020,7,9,체육대회,지출,2807,69803
2023,7,10,식사,수입,1830,71633
2020,4,14,식사,수입,7881,79514
2023,10,20,체육대회,수입,8235,87749
2021,3,23,식사,수입,1876,89625
2023,9,26,여행,지출,7929,81696
2020,7,2,체육대회,지출,2162,79534
2022,9,9,쇼핑,지출,5152,74382
2020,3,13,체육대회,수입,7744,82126
2023,12,4,쇼핑,지출,9914,72212
2023,1,18,쇼핑,지출,1317,70895
2022,8,17,MT,수입,2226,73121
2023,7,20,MT,수입,6555,79676
2020,7,22,식사,수입,3056,82732
2020,10,10,여행,지출,5317,77415
2020,10,26,MT,지출,5032,72383
2022,1,25,체육대회,지출,7423,64960
2023,8,11,체육대회,지출,9930,55030
2023,3,16,MT,지출,7395,47635
2022,1,2,쇼핑,지출,3503,44132
2020,11,21,쇼핑,수입,6498,50630
2023,8,6,여행,수입,9472,60102
2020,8,20,쇼핑,지출,2725,57377
2023,8,12,체육대회,수입,2358,59735
2023,6,30,MT,수입,1767,61502
2022,4,26,식사,수입,1976,63478
2022,10,20,MT,수입,4926,68404
2020,7,21,여행,지출,6330,62074
2021,7,16,쇼핑,지출,5175,56899
2020,4,10,쇼핑,지출,6515,50384
2022,2,19,체육대회,수입,5306,55690
2020,1,4,체육대회,지출,7769,47921
2022,6,10,여행,지출,1711,46210
2022,2,27,여행,수입,6489,52699
2022,9,25,쇼핑,수입,6744,59443
2023,1,7,여행,수입,5923,65366
2022,4,4,여행,지출,8969,56397
2023,6,17,식사,지출,2073,54324
2023,3,3,여행,지출,9345,44979
2022,2,12,쇼핑,지출,5532,39447
2021,7,30,식사,수입,8245,47692
2021,12,3,식사,지출,8450,39242
2020,3,11,식사,지출,3844,35398
2021,5,24,여행,수입,6323,41721
2021,10,25,쇼핑,수입,7195,48916
2021,9,30,쇼핑,수입,1989,50905
2021,2,7,여행,지출,7465,43440
2023,6,1,쇼핑,수입,6748,50188
2020,11,17,여행,지출,2564,47624
2022,8,1,여행,지출,4615,43009
2020,8,21,쇼핑,지출,1941,41068
2022,10,14,여행,수입,2111,43179
2020,9,5,식사,지출,5855,37324
2023,3,10,식사,지출,5356,31968
2022,3,13,쇼핑,지출,5918,26050
2022,4,16,여행,지출,6183,19867
2021,11,12,여행,수입,1961,21828
2021,6,12,쇼핑,지출,3833,17995
2023,8,11,MT,지출,9274,8721
2022,5,23,여행,지출,4915,3806
2020,7,23,체육대회,수입,9821,13627
2020,10,23,식사,지출,1690,11937
2020,6,10,MT,지출,6257,5680
2022,5,16,체육대회,수입,5189,10869
2021,4,23,쇼핑,지출,9687,1182
2021,5,6,여행,지출,8254,-7072
2022,8,19,MT,지출,7340,-14412
2021,2,16,여행,수입,4647,-9765
2022,8,20,체육대회,지출,7582,-17347
2023,12,29,식사,수입,1001,-16346
2020,12,9,여행,수입,6658,-9688
2022,12,26,여행,수입,4636,-5052
2023,6,26,식사,지출,9821,-14873
2020,1,30,MT,수입,9989,-4884
2021,1,19,MT,수입,5855,971
2022,8,7,식사,수입,8403,9374
2021,7,10,체육대회,수입,6964,16338
2023,5,18,체육대회,지출,5155,11183
2022,7,6,쇼핑,수입,3108,14291
2022,3,13,쇼핑,수입,5403,19694
2023,4,8,여행,지출,9219,10475
2022,5,10,여행,지출,2370,8105
2022,6,7,체육대회,지출,6960,1145
2021,10,8,식사,수입,2013,3158
2020,6,30,체육대회,지출,1509,1649
2021,6,20,MT,수입,9693,11342
2022,12,20,식사,지출,3854,7488
2022,8,22,MT,지출,1783,5705
2022,5,30,여행,수입,6994,12699
2020,11,19,MT,지출,7013,5686
2022,1,7,쇼핑,지출,2750,2936
2023,9,26,식사,지출,4054,-1118
2022,9,27,식사,수입,7055,5937
2020,12,23,여행,지출,1241,4696
2021,1,13,체육대회,수입,1763,6459
2022,8,26,쇼핑,지출,5447,1012
2020,8,23,체육대회,지출,1679,-667
2020,12,26,여행,수입,6333,5666
2023,9,24,식사,수입,4603,10269
2021,10,21,체육대회,지출,1117,9152
2023,10,5,MT,지출,3997,5155
2020,8,12,MT,수입,9686,14841
2022,9,20,체육대회,수입,2857,17698
2021,8,22,식사,수입,7271,24969
2020,8,4,체육대회,지출,3040,21929
2023,5,6,여행,수입,9432,31361
2023,3,8,체육대회,지출,7340,24021
2023,1,5,MT,지출,6036,17985
2020,10,25,쇼핑,지출,6057,11928
2023,1,16,체육대회,수입,7874,19802
2020,5,7,식사,수입,5546,25348
2021,2,12,여행,지출,3159,22189
2020,2,19,식사,수입,5670,27859
2021,11,26,MT,수입,7636,35495
2022,7,12,MT,지출,8639,26856
2023,11,16,체육대회,지출,4759,22097
2020,3,3,체육대회,지출,8517,13580
2023,4,9,체육대회,수입,5203,18783
2022,5,5,여행,지출,9837,8946
2022,1,9,MT,수입,8842,17788
2020,5,18,체육대회,수입,9145,26933
2022,12,12,식사,지출,9838,17095
2020,4,12,식사,지출,3132,13963
2021,7,23,여행,수입,3809,17772
2021,10,21,여행,수입,6695,24467
2020,10,8,여행,수입,5448,29915
2021,9,18,MT,수입,3693,33608
2022,1,16,쇼핑,수입,3584,37192
2020,1,20,여행,수입,9376,46568
2023,10,23,체육대회,수입,6885,53453
2020,12,9,여행,수입,5591,59044
2023,8,22,식사,수입,9847,68891
2021,3,6,쇼핑,지출,9995,58896
2020,5,2,식사,수입,7041,65937
2020,7,4,체육대회,수입,8963,74900
2020,2,8,체육대회,수입,1414,76314
2021,10,29,MT,지출,3892,72422
2022,6,7,MT,지출,7212,65210
2020,5,8,MT,수입,4502,69712
2023,2,12,식사,지출,3837,65875
2023,1,2,MT,지출,9381,56494
2020,6,6,식사,지출,9717,46777
2021,10,3,체육대회,수입,8783,55560
2022,2,11,식사,지출,3452,52108
2022,1,15,식사,지출,1730,50378
2020,11,14,쇼핑,수입,5214,55592
2020,7,9,쇼핑,지출,3081,52511
2020,11,11,여행,수입,1441,53952
2021,3,11,여행,지출,4218,49734
2023,2,24,MT,수입,3275,53009
2023,6,20,쇼핑,수입,2401,55410
2023,3,3,쇼핑,지출,9405,46005
2021,6,6,MT,수입,2821,48826
2023,9,8,여행,수입,2053,50879
2022,1,7,식사,지출,6302,44577
2022,11,10,쇼핑,수입,5206,49783
2021,4,12,체육대회,지출,7415,42368
2022,5,28,체육대회,수입,5541,47909
2022,11,8,여행,지출,4677,43232
2023,12,7,체육대회,지출,2840,40392
2023,1,11,여행,지출,6623,33769
2022,1,31,여행,수입,4573,38342
2020,8,28,여행,지출,1108,37234
2023,7,10,여행,지출,1632,35602
2021,6,24,체육대회,지출,9730,25872
2022,5,20,식사,지출,2253,23619
2023,5,24,체육대회,지출,1070,22549
2020,12,8,쇼핑,수입,6104,28653
2023,6,17,여행,수입,8123,36776
2020,7,17,MT,지출,6503,30273
2023,6,8,체육대회,수입,3138,33411
2021,10,20,쇼핑,수입,6754,40165
2021,10,10,여행,지출,2508,37657
2020,1,17,여행,수입,7277,44934
2023,8,30,여행,지출,6664,38270
2023,3,6,체육대회,수입,7431,45701
2022,9,1,여행,수입,9309,55010
2020,9,25,식사,수입,1502,56512
2020,12,13,식사,지출,1524,54988
2021,4,4,체육대회,지출,4894,50094
2022,10,22,쇼핑,지출,6772,43322
2023,8,5,MT,지출,3154,40168
2023,9,10,쇼핑,지출,1363,38805
2021,10,15,여행,지출,9931,28874
2020,3,2,쇼핑,수입,3967,32841
2021,7,19,체육대회,지출,4497,28344
2022,9,10,식사,지출,6228,22116
2023,4,26,쇼핑,수입,5844,27960
2020,10,29,체육대회,수입,8950,36910
2020,3,9,체육대회,수입,6125,43035
2021,1,4,식사,수입,7251,50286
2023,12,30,여행,수입,6733,57019
2020,11,23,쇼핑,지출,5902,51117
2020,12,14,MT,수입,6958,58075
2021,9,14,쇼핑,지출,2661,55414
2023,2,6,식사,수입,2230,57644
2021,3,24,식사,수입,7561,65205
2022,2,15,쇼핑,수입,5530,70735
2020,6,7,여행,지출,7797,62938
2020,1,19,식사,지출,8516,54422
2023,7,18,식사,수입,3752,58174
2022,11,4,쇼핑,지출,8235,49939
2021,6,19,MT,지출,3856,46083
2022,6,6,여행,수입,1604,47687
2020,12,6,체육대회,수입,9963,57650
2021,3,12,쇼핑,수입,5671,63321
2021,7,10,식사,수입,9035,72356
2023,8,27,식사,수입,2877,75233
2022,10,6,체육대회,수입,3591,78824
2020,1,17,쇼핑,수입,8674,87498
2022,1,12,식사,수입,5686,93184
2023,2,18,쇼핑,지출,1374,91810
2021,10,11,여행,지출,7655,84155
2021,1,25,MT,수입,9457,93612
2023,7,4,MT,수입,4003,97615
2022,4,21,쇼핑,수입,2763,100378
2021,11,14,식사,지출,6329,94049
2022,6,7,MT,지출,7785,86264
2020,2,25,MT,지출,4803,81461
2021,3,28,여행,지출,1422,80039
2022,8,22,식사,수입,9681,89720
2021,11,24,여행,수입,7702,97422
2020,1,30,체육대회,수입,6650,104072
2022,9,27,여행,수입,9975,114047
2022,8,4,MT,수입,9305,123352
2020,10,17,체육대회,수입,7558,130910
2022,2,27,식사,지출,2239,128671
2021,9,24,식사,지출,8707,119964
2021,12,6,MT,수입,7927,127891
2020,2,18,여행,수입,6241,134132
2023,6,28,체육대회,지출,1475,132657
2021,11,10,MT,지출,2530,130127
2020,6,6,식사,수입,4485,134612
2022,11,28,여행,수입,6850,141462
2021,1,21,식사,수입,1405,142867
2020,4,20,쇼핑,수입,1821,144688
2022,11,24,식사,수입,6472,151160
2021,1,31,여행,수입,5786,156946
2023,7,16,여행,수입,8222,165168
2023,11,25,MT,지출,6712,158456
2023,2,1,여행,지출,6637,151819
2021,10,9,여행,수입,1408,153227
2023,6,16,식사,지출,5098,148129
2020,7,28,식사,지출,4406,143723
2021,9,19,식사,지출,6836,136887
2021,8,30,쇼핑,지출,1555,135332
2021,2,12,체육대회,수입,1778,137110
2021,2,7,MT,지출,9689,127421
2022,3,13,체육대회,수입,2412,129833
2022,8,30,체육대회,지출,1501,128332
2020,11,26,여행,지출,1346,126986
2022,6,7,MT,지출,9011,117975
2021,1,26,체육대회,지출,8053,109922
2021,6,14,여행,수입,7695,117617
2020,12,20,쇼핑,지출,3719,113898
2023,8,17,식사,수입,8153,122051
2022,7,3,체육대회,지출,5038,117013
2022,1,14,체육대회,지출,2822,114191
2022,8,7,MT,수입,8474,122665
2021,11,3,MT,수입,6066,128731
2021,7,24,식사,수입,4800,133531
2021,3,23,식사,지출,7218,126313
2021,3,19,쇼핑,수입,7119,133432
2022,8,23,체육대회,수입,2950,136382
2022,2,25,쇼핑,지출,8701,127681
2020,8,4,쇼핑,지출,1072,126609
2020,4,11,체육대회,지출,7626,118983
2022,10,19,여행,지출,5442,113541
2021,4,8,여행,지출,5167,108374
2023,12,27,체육대회,지출,3934,104440
2021,5,4,식사,지출,9904,94536
2021,11,2,체육대회,지출,5494,89042
2020,10,10,식사,지출,6101,82941
2023,3,28,체육대회,지출,4963,77978
2023,3,31,쇼핑,수입,1544,79522
2022,12,20,식사,수입,2388,81910
2022,12,10,식사,지출,8021,73889
2020,12,5,쇼핑,지출,1218,72671
2023,9,26,체육대회,수입,4903,77574
2020,7,31,식사,수입,8302,85876
2021,8,30,체육대회,지출,4087,81789
2020,8,20,체육대회,수입,4199,85988
2020,3,24,MT,지출,8858,77130
2023,4,2,여행,수입,3124,80254
2021,5,21,MT,지출,3192,77062
2022,8,17,체육대회,지출,7063,69999
2022,4,10,쇼핑,지출,4125,65874
2023,10,13,여행,지출,1135,64739
2022,6,3,여행,수입,4589,69328
2022,8,3,쇼핑,지출,5085,64243
2022,12,20,MT,수입,4044,68287
2020,12,16,쇼핑,수입,9306,77593
2020,10,20,쇼핑,지출,3524,74069
2021,2,17,쇼핑,지출,9946,64123
2023,2,10,MT,지출,8744,55379
2020,2,5,여행,수입,5507,60886
2023,4,15,MT,수입,8079,68965
2020,2,26,MT,수입,3130,72095
2022,5,13,쇼핑,수입,6248,78343
2023,7,29,체육대회,지출,3388,74955
2022,3,13,MT,지출,3526,71429
2022,11,17,여행,수입,4267,75696
2020,8,18,식사,지출,5133,70563
2020,2,4,MT,지출,9040,61523
2020,1,29,체육대회,지출,2301,59222
2023,1,10,여행,수입,2764,61986
2021,8,22,MT,수입,6332,68318
2020,12,24,체육대회,수입,8022,76340
2021,12,25,여행,지출,2375,73965
2022,5,30,쇼핑,지출,3239,70726
2021,12,24,식사,수입,7664,78390
2020,12,20,체육대회,지출,5069,73321
2023,11,17,쇼핑,수입,3331,76652
2023,11,6,식사,수입,7440,84092
2021,12,7,쇼핑,지출,4036,80056
2022,4,12,여행,지출,8131,71925
2021,1,5,체육대회,지출,8358,63567
2023,9,26,MT,지출,8609,54958
2020,1,25,체육대회,지출,5327,49631
2022,3,13,여행,수입,3211,52842
2023,7,2,체육대회,수입,9060,61902
2023,11,13,쇼핑,수입,5361,67263
2022,6,27,MT,지출,5552,61711
2020,5,26,식사,수입,1420,63131
2020,2,23,MT,지출,1821,61310
2023,2,17,여행,지출,8991,52319
2023,3,15,쇼핑,수입,4611,56930
2021,4,18,MT,수입,7039,63969
2022,7,5,식사,수입,9558,73527
2021,9,15,MT,수입,8647,82174
2020,10,16,쇼핑,수입,5399,87573
2020,8,5,MT,수입,3649,91222
2022,12,8,식사,수입,6492,97714
2022,7,8,쇼핑,지출,2677,95037
2023,1,14,체육대회,수입,6159,101196
2023,4,6,MT,지출,9295,91901
2023,1,31,여행,수입,4681,96582
2023,6,16,쇼핑,수입,8278,104860
2022,9,3,식사,지출,3845,101015
2020,5,19,여행,수입,1235,102250
2023,11,4,체육대회,수입,7078,109328
2022,7,29,쇼핑,지출,8643,100685
2021,9,17,쇼핑,지출,8289,92396
2020,3,16,쇼핑,지출,5407,86989
2023,5,13,여행,수입,1741,88730
2020,1,2,쇼핑,수입,4930,93660
2023,12,17,식사,수입,1073,94733
2023,6,22,식사,지출,5753,88980
2022,9,19,여행,지출,1831,87149
2023,6,28,여행,수입,8542,95691
2022,3,18,쇼핑,지출,2529,93162
2021,8,19,쇼핑,수입,7523,100685
2023,6,26,MT,지출,9753,90932
2022,3,20,체육대회,수입,7796,98728
2023,9,14,식사,수입,4582,103310
2023,3,19,MT,지출,8241,95069
2021,10,24,쇼핑,지출,1809,93260
2022,9,27,여행,지출,4453,88807
2020,8,31,쇼핑,수입,7423,96230
2023,3,25,체육대회,지출,8086,88144
2021,3,14,여행,지출,10000,78144
2021,10,31,체육대회,수입,5229,83373
2021,5,27,쇼핑,지출,6603,76770
2022,7,31,체육대회,지출,7749,69021
2021,2,2,여행,지출,7677,61344
2022,12,8,체육대회,수입,1822,63166
2023,12,30,MT,수입,9713,72879
2023,5,10,식사,수입,1477,74356
2020,8,22,쇼핑,수입,9219,83575
2021,7,17,식사,지출,8380,75195
2021,11,25,체육대회,수입,1913,77108
2022,12,2,쇼핑,지출,1762,75346
2022,2,12,쇼핑,수입,6826,82172
2021,6,10,체육대회,지출,4133,78039
2020,8,14,체육대회,수입,3077,81116
2021,2,28,식사,수입,2194,83310
2020,6,8,쇼핑,지출,2161,81149
2021,12,15,여행,지출,5089,76060
2021,3,31,여행,수입,2604,78664
2023,12,21,체육대회,지출,6038,72626
2022,12,16,식사,수입,2071,74697
2021,10,30,쇼핑,지출,5925,68772
2020,1,27,여행,지출,8461,60311
2022,5,9,체육대회,수입,1269,61580
2022,1,2,MT,수입,6434,68014
2020,5,3,체육대회,수입,4896,72910
2020,1,21,식사,수입,3326,76236
2023,3,30,체육대회,지출,1552,74684
2022,12,22,여행,수입,6664,81348
2021,9,30,여행,지출,1193,80155
2020,12,10,식사,수입,8929,89084
2020,1,22,여행,지출,7643,81441
2022,9,22,쇼핑,수입,4863,86304
2021,11,12,식사,수입,2655,88959
2021,9,8,여행,지출,2061,86898
2020,5,6,MT,수입,3815,90713
2022,11,9,MT,수입,3582,94295
2022,1,6,체육대회,지출,5356,88939
2023,6,11,여행,수입,7081,96020
2020,12,9,여행,수입,1371,97391
2021,5,25,체육대회,수입,4081,101472
2021,9,13,쇼핑,수입,2017,103489
2022,3,3,MT,지출,9965,93524
2020,4,4,여행,수입,2528,96052
2021,2,25,체육대회,수입,7464,103516
2023,9,28,체육대회,수입,7043,110559
2021,5,1,체육대회,지출,2841,107718
2023,1,8,쇼핑,수입,4629,112347
2022,7,13,MT,수입,9881,122228
2023,6,16,체육대회,지출,8614,113614
2021,11,3,쇼핑,수입,3905,117519
2021,3,12,MT,수입,7224,124743
2023,4,27,쇼핑,수입,1030,125773
2020,9,6,체육대회,수입,6381,132154
2022,3,9,MT,수입,5244,137398
2022,3,19,여행,지출,3087,134311
2022,12,28,여행,수입,2653,136964
2021,3,19,쇼핑,수입,5467,142431
2023,4,27,여행,수입,8896,151327
2023,4,25,식사,수입,8272,159599
2020,9,29,여행,지출,8108,151491
2020,12,26,MT,지출,1936,149555
2022,5,2,식사,지출,2386,147169
2022,1,27,여행,수입,5249,152418
2021,3,28,쇼핑,지출,6310,146108
2021,12,2,식사,지출,5421,140687
2021,4,21,MT,지출,5328,135359
2022,3,5,식사,지출,7353,128006
2022,8,6,MT,수입,8589,136595
2022,7,16,체육대회,수입,5317,141912
2022,1,10,식사,수입,1431,143343
2023,10,6,체육대회,수입,1852,145195
2023,7,6,식사,수입,1504,146699
2020,5,13,MT,수입,5303,152002
2023,1,15,체육대회,지출,8089,143913
2020,11,16,체육대회,지출,3687,140226
2021,5,30,MT,수입,8964,149190
2023,8,28,쇼핑,수입,5742,154932
2021,4,18,쇼핑,수입,7827,162759
2020,7,2,여행,지출,1123,161636
2021,6,11,여행,수입,9721,171357
2022,1,18,식사,수입,1053,172410
2023,4,8,쇼핑,수입,2109,174519
2023,12,30,쇼핑,수입,5796,180315
2021,3,19,식사,수입,8227,188542
2020,1,15,여행,지출,1318,187224
2020,1,7,여행,수입,3436,190660
2022,7,17,여행,수입,8900,199560
2022,11,19,쇼핑,지출,8896,190664
2022,4,1,MT,지출,9282,181382
2023,6,6,여행,지출,7712,173670
2022,9,21,쇼핑,수입,6079,179749
2023,8,24,식사,수입,6595,186344
2022,4,20,여행,지출,9882,176462
2023,3,18,체육대회,수입,2885,179347
2021,11,18,쇼핑,지출,8108,171239
2023,3,4,여행,수입,5779,177018
2022,8,3,쇼핑,수입,2168,179186
2022,5,20,여행,지출,7631,171555
2021,9,6,쇼핑,수입,7175,178730
2021,3,23,식사,수입,8055,186785
2020,4,11,체육대회,수입,2603,189388
2021,8,28,체육대회,지출,5235,184153
2021,9,11,MT,지출,7274,176879
2022,3,13,여행,수입,6987,183866
2023,10,22,MT,지출,1099,182767
2021,11,18,쇼핑,지출,8932,173835
2023,1,30,쇼핑,지출,2360,171475
2023,4,28,쇼핑,수입,4440,175915
2023,2,14,체육대회,수입,3690,179605
2021,12,25,MT,수입,9981,189586
2022,4,14,체육대회,지출,4535,185051
2020,12,2,쇼핑,수입,1489,186540
2023,9,14,MT,지출,2271,184269
2021,1,9,쇼핑,지출,3615,180654
2023,3,11,쇼핑,수입,7268,187922
2022,12,20,쇼핑,지출,5607,182315
2023,8,25,체육대회,수입,2440,184755
2023,11,24,MT,수입,7911,192666
2023,4,21,여행,수입,1666,194332
2020,9,19,여행,수입,5938,200270
2022,8,20,쇼핑,지출,4803,195467
2021,5,24,MT,수입,4858,200325
2021,3,11,체육대회,지출,5752,194573
2021,7,5,여행,지출,3926,190647
2021,11,2,MT,지출,5962,184685
2022,2,19,여행,수입,6147,190832
2020,9,3,쇼핑,수입,1650,192482
2021,5,31,여행,지출,4454,188028
2022,10,22,체육대회,수입,7324,195352
2022,2,27,MT,지출,7261,188091
2020,3,12,체육대회,지출,5647,182444
2021,3,1,MT,지출,6643,175801
2020,6,14,쇼핑,지출,3294,172507
2022,9,5,MT,수입,4675,177182
2021,10,19,여행,지출,7746,169436
2020,12,11,MT,수입,6372,175808
2020,9,10,체육대회,지출,6134,169674
2023,8,21,MT,수입,3902,173576
2022,5,5,여행,수입,9142,182718
2023,4,16,쇼핑,지출,2699,180019
2023,3,25,쇼핑,수입,1389,181408
2020,8,28,쇼핑,수입,5370,186778
2023,11,17,쇼핑,지출,6708,180070
2020,1,8,체육대회,지출,7722,172348
2023,5,31,쇼핑,지출,2624,169724
2020,8,9,MT,지출,9607,160117
2021,6,22,체육대회,수입,8518,168635
2021,10,7,체육대회,지출,8292,160343
2023,8,29,식사,지출,8592,151751
2021,8,26,여행,수입,6790,158541
2021,7,2,체육대회,수입,6221,164762
2023,7,19,MT,수입,2636,167398
2020,7,24,쇼핑,지출,4723,162675
2021,8,18,여행,지출,7760,154915
2021,6,5,여행,수입,3515,158430
2022,10,29,체육대회,지출,4048,154382
2020,6,28,식사,수입,8264,162646
2023,4,26,체육대회,수입,8467,171113
2020,6,5,MT,지출,5165,165948
2021,5,9,체육대회,수입,4618,170566
2023,12,8,여행,지출,1782,168784
2023,9,17,여행,수입,6793,175577
2020,1,2,쇼핑,수입,4385,179962
2023,1,26,MT,수입,7816,187778
2021,3,23,식사,지출,1696,186082
2022,7,10,식사,지출,6451,179631
2023,9,12,여행,수입,8470,188101
2023,12,28,식사,수입,8976,197077
2022,5,6,여행,수입,9016,206093
2023,3,6,체육대회,수입,8001,214094
2023,1,11,여행,지출,3186,210908
2022,9,22,체육대회,수입,6472,217380
2023,10,4,체육대회,지출,4375,213005
2021,5,5,쇼핑,지출,4137,208868
2020,11,27,여행,지출,3262,205606
2020,6,30,쇼핑,지출,1170,204436
2023,10,16,체육대회,지출,1689,202747
2022,3,29,체육대회,지출,4455,198292
2022,2,16,여행,수입,1864,200156
2022,9,1,체육대회,수입,4034,204190
2023,9,27,식사,수입,1400,205590
2022,1,20,MT,지출,2171,203419
2023,9,6,여행,수입,7063,210482
2021,6,12,체육대회,수입,1446,211928
2021,9,27,쇼핑,수입,2290,214218
2022,2,19,쇼핑,지출,8850,205368
2020,8,11,체육대회,지출,9311,196057
2023,7,7,체육대회,지출,3950,192107
2022,10,15,식사,지출,9772,182335
2023,6,10,쇼핑,지출,1426,180909
2022,3,26,식사,지출,2260,178649
2023,11,11,MT,지출,5901,172748
2020,4,5,MT,수입,8171,180919
2021,4,6,여행,수입,6017,186936
2022,9,6,MT,수입,9678,196614
2021,11,28,MT,지출,4113,192501
2021,6,24,여행,지출,8420,184081
2022,9,14,식사,수입,7047,191128
2020,11,21,체육대회,지출,6967,184161
2020,3,20,체육대회,지출,9748,174413
2023,8,17,MT,지출,6083,168330
2022,7,9,식사,수입,9586,177916
2022,11,29,MT,수입,3730,181646
2021,5,21,쇼핑,수입,9623,191269
2020,2,3,체육대회,지출,4781,186488
2020,11,12,식사,지출,7940,178548
2022,7,2,여행,지출,8079,170469
2020,8,10,체육대회,지출,1898,168571
2022,3,9,여행,수입,7951,176522
2023,9,4,MT,수입,5650,182172
2023,8,19,쇼핑,수입,8604,190776
2022,5,27,MT,지출,4077,186699
2022,8,20,여행,지출,5489,181210
2023,11,26,MT,수입,9956,191166
2022,10,1,MT,수입,2162,193328
2023,2,3,쇼핑,지출,5521,187807
2021,6,2,체육대회,수입,8798,196605
2022,12,11,여행,지출,1922,194683
2023,2,24,식사,수입,9953,204636
2020,7,14,여행,수입,6962,211598
2021,3,6,체육대회,지출,1299,210299
2022,12,22,쇼핑,수입,2458,212757
2022,10,17,쇼핑,지출,2940,209817
2023,6,1,식사,수입,4614,214431
2023,3,15,체육대회,수입,1072,215503
2023,4,17,여행,지출,4000,211503
2021,7,2,MT,지출,6008,205495
2023,12,26,식사,수입,1841,207336
2020,6,11,체육대회,지출,8594,198742
2021,5,23,체육대회,지출,9779,188963
2020,8,7,체육대회,수입,5273,194236
2021,11,17,체육대회,지출,4858,189378
2023,10,15,여행,지출,6085,183293
2021,5,12,MT,수입,3839,187132
2020,7,20,체육대회,수입,8304,195436
2023,12,12,쇼핑,지출,9391,186045
2023,11,19,체육대회,지출,7693,178352
2023,11,12,식사,수입,4201,182553
2021,12,22,MT,지출,6311,176242
2022,6,7,체육대회,수입,2810,179052
2021,10,16,체육대회,지출,1757,177295
2021,11,15,체육대회,수입,5337,182632
2021,6,3,쇼핑,지출,6064,176568
2022,5,30,MT,수입,4415,180983
2023,3,11,MT,지출,7869,173114
2021,10,18,여행,수입,5395,178509
2022,4,13,쇼핑,지출,4643,173866
2023,12,22,여행,지출,7021,166845
2021,12,10,여행,수입,6238,173083
2021,4,8,쇼핑,수입,9458,182541
2022,8,23,식사,지출,5991,176550
2022,10,12,MT,지출,2075,174475
2023,7,8,여행,지출,4392,170083
2022,12,12,식사,지출,2341,167742
2021,3,24,MT,지출,6652,161090
2021,11,9,여행,수입,8273,169363
2020,10,18,쇼핑,수입,7593,176956
2020,9,24,체육대회,지출,1997,174959
2021,6,30,식사,지출,4031,170928
2021,5,12,식사,수입,7174,178102
2020,11,11,체육대회,수입,1036,179138
2021,7,28,체육대회,지출,1631,177507
2023,6,14,쇼핑,지출,2960,174547
2023,12,20,식사,지출,1946,172601
2021,1,15,식사,수입,5552,178153
2023,9,17,체육대회,수입,6867,185020
2021,4,28,체육대회,지출,5463,179557
2022,5,30,여행,지출,3856,175701
2021,11,25,식사,수입,7414,183115
2021,9,21,식사,수입,5392,188507
2021,4,28,체육대회,수입,1918,190425
2021,6,28,쇼핑,수입,8971,199396
2022,9,3,MT,수입,7873,207269
2022,7,26,체육대회,지출,9685,197584
2021,1,22,쇼핑,수입,4399,201983
2021,8,3,식사,지출,3917,198066
2020,9,10,식사,지출,2671,195395
2023,1,21,체육대회,수입,5564,200959
2023,5,31,쇼핑,수입,6807,207766
2023,6,12,MT,지출,6699,201067
2021,3,31,식사,수입,2116,203183
2023,4,14,식사,지출,7741,195442
2022,11,15,여행,지출,9063,186379
2022,5,1,체육대회,수입,7467,193846
2022,9,11,식사,지출,6225,187621
2020,2,13,식사,지출,6966,180655
2023,9,4,여행,수입,2624,183279
2020,6,19,여행,지출,8324,174955
2021,12,8,체육대회,지출,4953,170002
2020,5,11,여행,지출,4708,165294
2020,1,23,체육대회,지출,7140,158154
2023,10,7,식사,지출,6684,151470
2020,6,24,쇼핑,지출,6052,145418
2021,7,23,쇼핑,수입,5784,151202
2022,1,10,체육대회,지출,2823,148379
2023,6,17,체육대회,지출,1073,147306
2020,12,16,여행,수입,7593,154899
2021,10,5,여행,수입,4481,159380
2020,6,4,식사,지출,3626,155754
2020,6,2,MT,수입,6982,162736
2021,10,12,쇼핑,수입,3061,165797
2021,7,4,체육대회,지출,7665,158132
2020,8,24,식사,수입,1748,159880
2021,1,2,체육대회,지출,5873,154007
2021,4,26,MT,지출,8338,145669
2022,7,3,식사,지출,1405,144264
2023,6,16,쇼핑,지출,6004,138260
2022,4,2,MT,수입,6690,144950
2022,11,1,쇼핑,지출,5724,139226
2020,9,3,체육대회,지출,8990,130236
2022,5,12,식사,지출,3592,126644
2022,3,6,MT,수입,1652,128296
2023,9,3,쇼핑,수입,8916,137212
2020,12,24,MT,지출,4127,133085
2022,4,12,MT,수입,4459,137544
2023,10,13,MT,지출,6491,131053
2022,9,11,여행,수입,7727,138780
2023,5,8,여행,수입,4906,143686
2023,8,15,쇼핑,지출,3085,140601
2022,4,28,체육대회,수입,8531,149132
2020,7,29,체육대회,수입,7180,156312
2023,12,10,쇼핑,수입,4719,161031
2022,11,2,MT,수입,1763,162794
2020,3,25,여행,수입,1999,164793
2023,7,25,식사,지출,8337,156456
2023,10,19,여행,수입,1759,158215
2020,9,7,식사,수입,5291,163506
2022,7,15,식사,수입,8390,171896
2021,2,17,쇼핑,지출,9570,162326
2022,1,4,쇼핑,수입,6164,168490
2021,8,2,여행,지출,2896,165594
2021,6,25,체육대회,수입,4543,170137
2020,7,13,여행,지출,6132,164005
2023,8,31,체육대회,수입,3581,167586
2020,12,29,여행,지출,9175,158411
2022,5,19,MT,수입,9899,168310
2022,4,26,쇼핑,지출,6588,161722
2020,12,26,쇼핑,수입,5657,167379
2020,2,25,체육대회,수입,5307,172686
2021,3,26,식사,지출,2957,169729
2023,8,18,체육대회,수입,1017,170746
2021,11,17,식사,지출,7660,163086
2023,11,5,여행,수입,6403,169489
2022,5,8,식사,지출,4073,165416
2023,7,3,MT,지출,6227,159189
2023,3,15,쇼핑,수입,1056,160245
2023,12,2,쇼핑,수입,9737,169982
2023,2,8,식사,지출,2466,167516
2022,8,24,MT,수입,5703,173219
2022,5,27,체육대회,지출,5897,167322
2022,6,4,여행,지출,5326,161996
2022,6,27,여행,지출,3432,158564
2022,7,17,여행,지출,8606,149958
2020,11,18,쇼핑,수입,3937,153895
2020,3,29,쇼핑,수입,9979,163874
2020,7,25,여행,지출,3874,160000
2022,3,6,쇼핑,지출,7581,152419
2023,2,20,체육대회,지출,9376,143043
2020,1,27,식사,지출,3438,139605
2020,7,27,체육대회,지출,1195,138410
2020,9,21,여행,지출,2340,136070
2022,11,24,체육대회,수입,8444,144514
2023,9,5,여행,수입,4781,149295
2023,1,21,쇼핑,지출,8113,141182
2023,3,29,체육대회,지출,2532,138650
2023,3,4,여행,지출,1903,136747
2022,7,6,MT,수입,3929,140676
2021,2,11,체육대회,수입,1288,141964
2020,1,14,여행,수입,6068,148032
2020,6,4,체육대회,수입,7024,155056
2023,4,28,식사,수입,9562,164618
2022,8,28,여행,지출,7948,156670
2021,3,17,여행,지출,2524,154146
2022,6,5,식사,지출,3493,150653
2022,4,5,여행,지출,1359,149294
2021,9,29,식사,지출,2887,146407
2023,11,26,쇼핑,수입,8454,154861
2023,1,21,쇼핑,수입,1304,156165
2022,3,22,쇼핑,수입,1757,157922
2021,7,8,MT,지출,6388,151534
2022,10,15,체육대회,수입,2792,154326
2022,5,1,식사,수입,3847,158173
2023,1,19,MT,수입,6714,164887
2022,12,30,식사,지출,7876,157011
2022,3,25,여행,수입,7762,164773
2022,10,16,체육대회,지출,8006,156767
2021,5,3,여행,지출,2148,154619
2020,1,2,식사,수입,3402,158021
2022,8,8,MT,수입,9493,167514
2021,5,14,MT,수입,4706,172220
2023,12,1,식사,수입,1013,173233
2021,5,7,체육대회,수입,3304,176537
2022,4,18,식사,수입,8944,185481
2023,5,27,식사,수입,9574,195055
2023,10,22,쇼핑,수입,6002,201057
2021,12,14,체육대회,수입,4098,205155
2022,12,21,쇼핑,지출,3914,201241
2021,1,2,쇼핑,수입,4248,205489
2020,2,28,식사,수입,1822,207311
2021,12,24,체육대회,수입,3139,210450
2023,9,30,여행,지출,8572,201878
2021,9,9,MT,지출,3552,198326
2023,7,13,여행,수입,6712,205038
2021,6,4,식사,지출,3105,201933
2023,4,22,MT,지출,3844,198089
2020,9,10,식사,수입,5764,203853
2023,4,15,여행,지출,7527,196326
2022,5,30,쇼핑,지출,8315,188011
2023,10,8,MT,수입,6411,194422
2023,10,14,식사,수입,4310,198732
2022,6,5,체육대회,지출,6176,192556
2021,5,16,체육대회,지출,2903,189653
2023,5,30,쇼핑,수입,5211,194864
2022,7,13,여행,수입,2475,197339
2022,12,19,체육대회,지출,5641,191698
2022,1,31,쇼핑,수입,6751,198449
2022,12,17,쇼핑,지출,3220,195229
2020,11,24,MT,지출,3614,191615
2021,8,13,쇼핑,지출,5231,186384
2023,9,30,MT,지출,8364,178020
2023,8,7,쇼핑,지출,6501,171519
2023,6,21,체육대회,지출,2174,169345
2023,7,10,쇼핑,지출,9795,159550
2020,5,19,여행,지출,8360,151190
2020,5,6,쇼핑,지출,3821,147369
2022,4,23,식사,수입,4818,152187
2020,5,26,MT,지출,2310,149877
2023,2,10,쇼핑,수입,5747,155624
2023,8,16,여행,수입,4120,159744
2020,2,11,쇼핑,지출,4869,154875
2023,1,14,체육대회,수입,2175,157050
2023,2,13,MT,수입,1628,158678
2023,9,21,체육대회,지출,7891,150787
2022,1,30,식사,수입,3008,153795
2021,4,16,여행,지출,3818,149977
2021,8,11,식사,수입,5139,155116
2021,6,27,MT,지출,6495,148621
2023,4,26,쇼핑,지출,1207,147414
2023,12,8,식사,수입,9548,156962
2023,2,5,식사,수입,1318,158280
2020,2,9,여행,지출,7313,150967
2020,1,22,식사,수입,4903,155870
2021,11,5,체육대회,지출,3948,151922
2021,5,26,여행,지출,6868,145054
2022,11,26,체육대회,지출,1772,143282
2021,8,23,여행,수입,7603,150885
2021,9,2,체육대회,지출,2336,148549
2023,8,12,체육대회,지출,4144,144405
2021,6,25,MT,지출,2144,142261
2023,8,19,쇼핑,지출,3631,138630
2023,8,21,쇼핑,수입,7761,146391
2020,9,10,체육대회,수입,8647,155038
2022,7,20,여행,지출,9212,145826
2021,11,24,쇼핑,수입,7133,152959
2022,3,24,여행,지출,9957,143002
2023,3,4,MT,지출,4131,138871
2021,2,21,식사,지출,1030,137841
2020,2,16,체육대회,수입,3435,141276
2023,8,16,식사,지출,6477,134799
2023,6,12,MT,지출,1791,133008
2022,7,9,MT,지출,8291,124717
2020,9,23,식사,수입,1445,126162
2021,12,19,여행,지출,2501,123661
2023,8,20,쇼핑,수입,8891,132552
2023,1,28,여행,지출,8657,123895
2020,4,28,여행,지출,4037,119858
2020,9,12,MT,지출,6736,113122
2022,9,13,체육대회,지출,8867,104255
2023,3,2,쇼핑,지출,7350,96905
2021,9,26,식사,지출,2793,94112
2023,9,9,식사,수입,3058,97170
2021,5,22,체육대회,지출,4348,92822
2022,8,7,체육대회,지출,7336,85486
2020,12,3,쇼핑,지출,7992,77494
2022,5,4,식사,수입,7493,84987
2022,1,22,식사,수입,9987,94974
2020,6,28,여행,수입,3370,98344
2023,6,6,식사,지출,9745,88599
2022,3,6,MT,수입,1338,89937
2022,12,27,MT,수입,7436,97373
2021,10,21,MT,수입,5232,102605
2023,11,16,체육대회,수입,4425,107030
2020,6,26,MT,지출,5032,101998
2020,5,30,여행,수입,5100,107098
2022,12,7,체육대회,수입,6105,113203
2022,8,3,쇼핑,지출,1385,111818
2022,2,7,식사,지출,5109,106709
2021,5,9,식사,수입,9111,115820
2020,8,29,체육대회,수입,2362,118182
2023,8,23,체육대회,수입,8169,126351
2022,6,17,체육대회,지출,9606,116745
2021,4,23,식사,수입,1144,117889
2022,5,9,식사,수입,1405,119294
2020,3,19,여행,수입,1074,120368
2023,8,23,식사,지출,6241,114127
2023,12,20,식사,수입,2426,116553
2020,4,30,쇼핑,지출,9522,107031
2021,6,22,여행,수입,3224,110255
2022,1,20,식사,수입,4755,115010
2021,4,1,식사,지출,6941,108069
2022,6,3,MT,수입,1388,109457
2021,1,23,식사,수입,2102,111559
2022,6,20,MT,수입,3645,115204
2021,11,11,MT,지출,1195,114009
2021,9,2,쇼핑,수입,5500,119509
2023,4,24,여행,지출,8550,110959
2020,7,30,체육대회,지출,5676,105283
2021,8,11,식사,지출,2285,102998
2021,11,15,쇼핑,지출,6276,96722
2020,5,12,여행,수입,6141,102863
2021,6,6,체육대회,지출,2690,100173
2021,7,11,식사,수입,6347,106520
2022,2,1,체육대회,지출,1148,105372
2020,3,22,식사,수입,7280,112652
2023,3,30,식사,지출,1515,111137
2021,11,3,식사,지출,4029,107108
2023,2,24,여행,지출,2713,104395
2020,4,28,여행,수입,4904,109299
2022,1,31,여행,지출,1689,107610
2020,3,26,쇼핑,수입,2399,110009
2020,6,23,식사,수입,8876,118885
2022,1,27,쇼핑,지출,4180,114705
2021,7,25,쇼핑,수입,1108,115813
2023,6,15,체육대회,지출,2848,112965
2022,10,22,식사,수입,7965,120930
2023,5,18,쇼핑,수입,1063,121993
2020,11,22,쇼핑,지출,9233,112760
2020,5,5,식사,수입,2139,114899
2020,6,16,체육대회,지출,5566,109333
2020,5,23,여행,지출,2255,107078
2022,6,25,체육대회,지출,3503,103575
2021,3,31,식사,지출,2495,101080
2021,2,26,MT,수입,5515,106595
2023,6,20,체육대회,수입,8796,115391
2021,8,28,쇼핑,수입,1127,116518
2022,8,3,여행,지출,9818,106700
2021,2,17,여행,수입,9841,116541
2020,3,19,여행,지출,4423,112118
2022,2,2,MT,지출,3005,109113
2022,1,24,여행,지출,8973,100140
2021,5,23,식사,지출,2333,97807
2023,6,28,쇼핑,수입,1990,99797
2022,12,25,MT,지출,9211,90586
2021,10,18,식사,수입,4039,94625
2023,4,13,쇼핑,수입,2027,96652
2021,12,29,MT,지출,6882,89770
2023,9,27,체육대회,지출,5484,84286
2020,5,25,여행,지출,1343,82943
2023,9,21,여행,수입,8797,91740
2021,8,23,쇼핑,수입,2085,93825
2020,8,24,체육대회,수입,3484,97309
2023,8,30,쇼핑,지출,2597,94712
2021,5,1,여행,지출,7361,87351
2020,6,26,MT,수입,2274,89625
2021,10,4,MT,수입,7052,96677
2023,5,12,체육대회,수입,4116,100793
2022,5,9,여행,수입,3479,104272
2020,2,5,체육대회,지출,2159,102113
2020,6,29,쇼핑,수입,9965,112078
2021,4,7,MT,지출,6136,105942
2022,10,5,여행,지출,7236,98706
2021,11,15,여행,수입,6879,105585
2023,6,7,여행,지출,9713,95872
2021,11,17,식사,지출,5776,90096
2020,7,9,체육대회,수입,5283,95379
2021,4,22,여행,지출,6405,88974
2021,3,8,쇼핑,수입,6430,95404
2020,6,17,체육대회,지출,1206,94198
2022,7,3,MT,수입,8084,102282
2021,9,20,MT,지출,9928,92354
2021,1,4,체육대회,수입,5820,98174
2020,2,12,체육대회,지출,8799,89375
2023,2,17,MT,수입,2152,91527
2021,7,14,여행,수입,6386,97913
2020,8,21,여행,수입,7286,105199
2021,12,27,MT,지출,6788,98411
2022,4,2,여행,지출,7882,90529
2022,12,25,체육대회,지출,5264,85265
2022,2,11,여행,수입,5562,90827
2023,9,7,체육대회,수입,2418,93245
2020,11,22,쇼핑,수입,3097,96342
2023,10,5,체육대회,수입,4901,101243
2020,9,8,체육대회,지출,4359,96884
2022,10,31,여행,지출,6195,90689
2022,5,17,체육대회,수입,4612,95301
2022,10,10,식사,수입,6070,101371
2023,10,18,MT,수입,3882,105253
2023,7,12,쇼핑,수입,4119,109372
2020,3,26,MT,지출,1232,108140
2021,2,10,식사,수입,7043,115183
2020,5,2,쇼핑,지출,5174,110009
2020,1,15,여행,지출,8151,101858
2021,9,17,체육대회,지출,6468,95390
2023,9,6,MT,수입,6465,101855
2020,4,9,여행,수입,6940,108795
2020,5,25,MT,지출,7332,101463
2020,3,27,MT,지출,5541,95922
2022,6,4,MT,수입,6325,102247
2022,1,31,MT,지출,8411,93836
2022,1,4,체육대회,지출,8112,85724
2022,5,14,식사,지출,8567,77157
2022,6,13,체육대회,수입,7322,84479
2021,2,11,체육대회,수입,2433,86912
2022,10,15,MT,수입,8906,95818
2021,7,27,체육대회,수입,7752,103570
2022,10,20,쇼핑,수입,5376,108946
2021,7,9,여행,지출,6743,102203
2023,11,1,MT,지출,1613,100590
2021,12,3,MT,지출,8491,92099
2020,12,16,식사,지출,2549,89550
2022,12,18,식사,지출,9601,79949
2021,1,18,MT,수입,7465,87414
2022,7,20,여행,수입,5133,92547
2023,2,24,체육대회,수입,8081,100628
2023,7,25,MT,지출,4988,95640
2022,10,24,MT,지출,5369,90271
2020,5,19,식사,수입,6942,97213
2020,12,3,체육대회,지출,5131,92082
2021,9,7,체육대회,수입,3680,95762
2023,5,7,체육대회,수입,3370,99132
2023,11,9,MT,수입,5257,104389
2021,4,25,여행,수입,2434,106823
2021,11,7,여행,지출,4274,102549
2023,12,3,여행,지출,2828,99721
2023,2,12,MT,수입,3381,103102
2023,5,1,쇼핑,지출,7680,95422
2022,4,27,MT,수입,5835,101257
2020,10,7,쇼핑,지출,2829,98428
2023,6,22,여행,지출,3398,95030
2023,12,11,체육대회,지출,4937,90093
2020,12,17,체육대회,지출,6480,83613
2021,10,20,체육대회,지출,2515,81098
2023,7,24,체육대회,수입,8067,89165
2020,3,30,여행,지출,4304,84861
2022,1,16,쇼핑,수입,9578,94439
2022,2,1,식사,수입,9227,103666
2022,9,25,MT,지출,6642,97024
2020,4,26,식사,수입,4022,101046
2023,12,20,식사,지출,3800,97246
2023,9,26,식사,지출,4421,92825
2023,6,22,여행,수입,9536,102361
2021,4,1,쇼핑,지출,9527,92834
2022,11,28,체육대회,수입,4252,97086
2022,8,11,식사,수입,7585,104671
2022,10,29,식사,수입,4783,109454
2022,9,4,여행,수입,1171,110625
2022,7,27,여행,수입,9078,119703
2023,10,9,식사,지출,7997,111706
2020,7,9,식사,지출,6458,105248
2020,9,10,체육대회,수입,8286,113534
2023,5,26,여행,지출,6751,106783
2020,2,18,식사,지출,6088,100695
2022,5,17,여행,수입,2949,103644
2020,12,3,체육대회,지출,1546,102098
2022,4,13,쇼핑,지출,1483,100615
2020,12,1,체육대회,수입,9076,109691
2023,6,29,여행,수입,2405,112096
2022,9,27,쇼핑,지출,8605,103491
2021,11,23,체육대회,수입,6739,110230
2020,9,25,식사,지출,1975,108255
2022,3,7,쇼핑,지출,5703,102552
2023,10,9,여행,지출,8884,93668
2020,11,1,체육대회,수입,1455,95123
2022,3,19,식사,수입,3264,98387
2021,11,14,식사,지출,2453,95934
2020,5,11,쇼핑,지출,8404,87530
2021,8,6,여행,지출,7265,80265
2021,5,25,체육대회,수입,2409,82674
2021,11,29,쇼핑,지출,4159,78515
2020,12,17,체육대회,수입,4812,83327
2023,12,28,체육대회,수입,7185,90512
2023,1,11,식사,지출,1678,88834
2022,7,10,여행,지출,9017,79817
2021,1,12,쇼핑,지출,7841,71976
2021,7,25,식사,수입,3555,75531
2023,12,15,MT,지출,9729,65802
2021,11,13,쇼핑,지출,7859,57943
2020,2,8,MT,지출,4493,53450
2023,5,20,식사,수입,6885,60335
2020,9,25,쇼핑,지출,2218,58117
2020,10,22,쇼핑,수입,2035,60152
2020,2,25,여행,지출,1114,59038
2022,3,9,MT,수입,1338,60376
2020,9,5,식사,지출,4824,55552
2020,9,5,식사,수입,2094,57646
2023,8,4,식사,수입,1610,59256
2023,6,3,쇼핑,지출,1916,57340
2020,8,25,여행,지출,7392,49948
2021,2,6,쇼핑,수입,2213,52161
2022,10,26,체육대회,수입,3125,55286
2022,8,27,쇼핑,수입,1041,56327
2023,12,7,체육대회,지출,5827,50500
2021,4,25,식사,지출,1010,49490
2022,11,3,식사,수입,6738,56228
2022,2,16,MT,지출,9297,46931
2022,8,28,식사,지출,3390,43541
2023,5,5,여행,지출,3483,40058
2020,10,18,체육대회,수입,8311,48369
2022,9,21,MT,지출,7980,40389
2022,12,4,MT,수입,2787,43176
2022,2,27,식사,지출,4407,38769
2022,5,3,MT,지출,5194,33575
2022,12,5,여행,지출,4947,28628
2021,3,6,여행,지출,5613,23015
2021,11,11,체육대회,수입,7515,30530
2023,8,24,체육대회,수입,7382,37912
2021,2,5,MT,수입,9281,47193
2022,4,17,쇼핑,수입,2620,49813
2022,10,15,식사,수입,4204,54017
2022,5,1,식사,수입,7579,61596
2021,1,3,여행,수입,1281,62877
2023,4,1,쇼핑,수입,4850,67727
2022,10,27,체육대회,지출,7778,59949
2020,2,22,체육대회,수입,3200,63149
2021,7,23,식사,수입,3116,66265
2022,12,29,쇼핑,수입,4325,70590
2021,9,11,체육대회,수입,9544,80134
2023,1,17,MT,지출,1328,78806
2023,11,2,여행,수입,2595,81401
2023,12,14,식사,수입,1061,82462
2023,9,30,쇼핑,수입,7568,90030
2020,7,20,여행,수입,9086,99116
2023,7,26,여행,지출,7511,91605
2023,10,21,쇼핑,수입,3278,94883
2022,3,19,MT,지출,7429,87454
2020,5,28,체육대회,수입,8891,96345
2020,1,29,식사,지출,6325,90020
2022,5,11,체육대회,지출,4670,85350
2021,4,2,MT,수입,3254,88604
2020,2,17,식사,지출,4332,84272
2020,8,19,체육대회,지출,9964,74308
2020,5,27,식사,수입,4511,78819
2020,12,19,체육대회,수입,4051,82870
2020,10,2,MT,수입,8187,91057
2022,7,3,체육대회,수입,3470,94527
2023,8,16,체육대회,지출,2843,91684
2021,8,7,여행,지출,2475,89209
2021,8,11,식사,수입,2392,91601
2023,11,30,MT,지출,8664,82937
2022,6,9,쇼핑,수입,2013,84950
2021,4,19,쇼핑,지출,9920,75030
2020,12,25,체육대회,지출,7702,67328
2022,6,12,MT,수입,4398,71726
2020,4,24,쇼핑,지출,4036,67690
2021,3,25,체육대회,수입,6982,74672
2021,1,30,쇼핑,지출,5456,69216
2022,11,8,식사,수입,5350,74566
2023,2,24,쇼핑,수입,4976,79542
2023,12,31,MT,지출,6863,72679
2023,7,25,식사,수입,6051,78730
2020,6,4,MT,수입,6043,84773
2021,10,3,여행,수입,5066,89839
2020,9,24,식사,지출,2364,87475
2020,11,15,체육대회,수입,1395,88870
2023,9,10,체육대회,지출,4675,84195
2020,4,7,MT,지출,2503,81692
2022,11,19,체육대회,수입,5448,87140
2020,5,26,식사,수입,5536,92676
2022,12,7,MT,수입,3499,96175
2021,11,8,식사,수입,2674,98849
2023,7,14,여행,수입,5471,104320
2022,7,8,쇼핑,수입,1354,105674
2023,2,19,체육대회,수입,8772,114446
2022,9,14,MT,지출,2723,111723
2023,8,24,MT,지출,9407,102316
2022,9,10,쇼핑,수입,3725,106041
2020,2,23,체육대회,수입,9196,115237
2020,8,1,여행,지출,5596,109641
2020,10,30,쇼핑,지출,9065,100576
2021,4,30,여행,지출,1816,98760
2023,10,26,MT,수입,9355,108115
2022,2,19,쇼핑,수입,8390,116505
2022,11,11,쇼핑,수입,4096,120601
2022,9,20,식사,지출,6712,113889
2021,9,6,쇼핑,지출,2391,111498
2020,3,30,체육대회,수입,6652,118150
2020,10,19,여행,지출,6981,111169
2023,5,12,체육대회,수입,9991,121160
2021,8,23,MT,수입,4120,125280
2020,2,23,쇼핑,지출,1651,123629
2021,8,31,쇼핑,수입,7715,131344
2021,9,25,여행,수입,7902,139246
2021,6,2,MT,수입,4458,143704
2020,10,30,여행,수입,9281,152985
2021,12,30,여행,지출,3304,149681
2021,9,13,식사,수입,1438,151119
2022,1,26,식사,수입,3261,154380
2021,4,21,쇼핑,지출,1649,152731
2021,11,11,여행,수입,4228,156959
2023,11,25,식사,지출,1608,155351
2020,5,2,식사,수입,6239,161590
2020,4,24,식사,지출,1595,159995
2023,12,6,식사,수입,2933,162928
2023,12,3,쇼핑,지출,2124,160804
2023,5,21,체육대회,수입,5129,165933
2020,1,13,식사,지출,8373,157560
2021,5,9,체육대회,지출,7671,149889
2020,2,3,여행,지출,7627,142262
2020,8,27,쇼핑,지출,4652,137610
2020,8,18,식사,수입,8483,146093
2020,11,8,체육대회,수입,8623,154716
2023,8,22,MT,지출,4901,149815
2023,3,12,MT,수입,6926,156741
2023,12,23,체육대회,지출,7612,149129
2022,8,25,MT,수입,1236,150365
2023,2,13,체육대회,수입,1841,152206
2023,1,7,쇼핑,수입,7147,159353
2021,2,17,여행,지출,7307,152046
2021,8,12,쇼핑,수입,6880,158926
2022,7,10,MT,지출,4214,154712
2022,8,14,식사,수입,1508,156220
2020,6,15,쇼핑,지출,3123,153097
2020,4,10,식사,수입,8771,161868
2021,2,2,체육대회,지출,1126,160742
2021,9,28,여행,지출,2114,158628
2022,11,6,식사,수입,7235,165863
2021,3,30,쇼핑,지출,7295,158568
2022,5,16,체육대회,지출,9054,149514
2020,2,16,쇼핑,지출,6988,142526
2023,7,14,식사,지출,5929,136597
2023,2,3,MT,수입,5021,141618
2023,11,26,쇼핑,지출,7445,134173
2023,11,10,여행,수입,4489,138662
2020,11,2,MT,지출,2416,136246
2023,2,12,쇼핑,수입,1408,137654
2021,9,29,MT,수입,6881,144535
2023,10,1,MT,수입,8881,153416
2023,2,20,MT,지출,2483,150933
2021,12,10,쇼핑,지출,7922,143011
2023,4,28,체육대회,지출,6945,136066
2022,3,10,여행,지출,1787,134279
2021,9,19,쇼핑,수입,9879,144158
2020,10,16,체육대회,지출,8216,135942
2023,12,13,여행,수입,3938,139880
2020,1,15,체육대회,지출,6692,133188
2023,2,15,식사,수입,7790,140978
2022,9,23,여행,수입,1497,142475
2022,11,21,MT,지출,3761,138714
2021,7,31,여행,수입,8744,147458
2021,11,18,체육대회,지출,7414,140044
2022,7,28,쇼핑,지출,2677,137367
2023,4,3,체육대회,지출,9735,127632
2021,3,31,식사,지출,6324,121308
2023,11,30,여행,수입,6354,127662
2023,7,18,MT,지출,4310,123352
2023,6,3,식사,지출,4321,119031
2022,7,5,MT,수입,4859,123890
2020,2,1,여행,지출,3036,120854
2023,10,5,식사,지출,1058,119796
2023,2,14,여행,지출,7069,112727
2021,3,19,쇼핑,지출,9407,103320
2021,6,6,체육대회,지출,2196,101124
2022,5,2,MT,지출,6396,94728
2022,8,22,쇼핑,지출,9000,85728
2020,4,11,체육대회,수입,9472,95200
2023,1,8,쇼핑,수입,8608,103808
2020,9,14,식사,수입,3869,107677
2023,4,18,MT,지출,4946,102731
2020,6,26,쇼핑,수입,3388,106119
2023,4,9,체육대회,지출,4789,101330
2020,9,9,식사,지출,9993,91337
2020,7,12,여행,지출,2603,88734
2022,3,10,MT,지출,8817,79917
2022,10,26,여행,수입,1360,81277
2020,7,10,식사,지출,1088,80189
2022,7,8,MT,지출,9603,70586
2023,4,20,MT,수입,1069,71655
2022,4,30,MT,수입,4503,76158
2020,6,26,여행,지출,8578,67580
2022,11,28,체육대회,수입,1662,69242
2020,2,26,쇼핑,수입,4736,73978
2022,3,29,MT,수입,4027,78005
2023,3,6,MT,수입,9259,87264
2022,9,23,MT,지출,7790,79474
2021,4,9,MT,수입,5602,85076
2021,6,28,MT,지출,5866,79210
2023,4,26,체육대회,수입,2561,81771
2023,11,26,여행,수입,9938,91709
2022,6,17,MT,지출,7835,83874
2022,4,27,식사,수입,8908,92782
2022,11,23,쇼핑,수입,6643,99425
2021,11,28,MT,지출,7373,92052
2023,12,1,MT,수입,3540,95592
2020,5,23,여행,수입,7357,102949
2021,1,30,여행,수입,6822,109771
2023,3,29,여행,지출,8646,101125
2023,12,11,쇼핑,지출,8704,92421
2022,3,28,식사,지출,9929,82492
2023,7,29,여행,수입,1964,84456
2022,1,30,식사,수입,2168,86624
2022,4,5,식사,지출,3646,82978
2022,4,20,MT,지출,5207,77771
2023,12,6,여행,수입,5339,83110
2021,5,29,체육대회,수입,5630,88740
2021,12,24,MT,수입,1615,90355
2021,4,26,식사,수입,5854,96209
2021,2,26,쇼핑,수입,5788,101997
2020,4,9,식사,지출,1746,100251
2021,2,15,식사,수입,3421,103672
2022,7,1,쇼핑,수입,6891,110563
2022,9,23,여행,수입,8749,119312
2021,5,25,쇼핑,지출,8301,111011
2021,3,5,체육대회,지출,5331,105680
2022,1,9,MT,지출,4816,100864
2022,7,23,여행,수입,1849,102713
2021,4,10,식사,지출,1132,101581
2021,5,4,쇼핑,지출,6496,95085
2021,8,17,여행,수입,4840,99925
2022,6,29,체육대회,수입,6783,106708
2020,7,11,쇼핑,수입,2274,108982
2020,5,6,쇼핑,수입,3201,112183
2020,5,2,여행,수입,3869,116052
2021,10,10,체육대회,지출,3786,112266
2023,3,1,MT,수입,3408,115674
2023,9,19,MT,수입,3075,118749
2022,3,29,여행,지출,9128,109621
2022,9,2,체육대회,수입,1966,111587
2022,4,29,체육대회,지출,5017,106570
2020,7,22,여행,수입,9649,116219
2022,8,29,체육대회,수입,9879,126098
2022,10,8,쇼핑,지출,4409,121689
2021,3,16,식사,지출,6493,115196
2023,10,16,MT,수입,1054,116250
2023,12,20,체육대회,지출,2135,114115
2023,3,11,체육대회,수입,7277,121392
2020,1,2,MT,수입,3229,124621
2020,12,3,여행,지출,7755,116866
2022,9,17,쇼핑,수입,1938,118804
2021,4,1,MT,지출,2852,115952
2020,3,17,식사,수입,5266,121218
2022,8,17,쇼핑,지출,7432,113786
2023,3,28,체육대회,지출,5437,108349
2021,3,14,체육대회,수입,6119,114468
2023,4,1,MT,수입,1493,115961
2023,10,10,체육대회,수입,9037,124998
2021,6,24,식사,수입,1720,126718
2020,12,4,MT,수입,6841,133559
2022,8,25,체육대회,지출,7640,125919
2022,3,17,MT,수입,8626,134545
2020,1,5,체육대회,지출,2949,131596
2021,1,15,여행,지출,2409,129187
2022,10,23,식사,지출,7509,121678
2021,4,9,MT,수입,5326,127004
2022,11,11,체육대회,수입,1707,128711
2023,1,28,쇼핑,수입,5836,134547
2023,7,20,쇼핑,수입,4921,139468
2021,10,19,체육대회,지출,6885,132583
2023,12,10,식사,지출,9435,123148
2023,2,27,여행,수입,7716,130864
2023,4,21,여행,수입,2888,133752
2020,10,9,여행,수입,7526,141278
2020,12,1,여행,수입,6482,147760
2023,11,25,MT,수입,6066,153826
2020,8,8,쇼핑,수입,9287,163113
2020,8,10,체육대회,지출,3665,159448
2022,10,17,MT,지출,4496,154952
2022,9,22,MT,지출,6010,148942
2020,9,19,식사,지출,6884,142058
2023,11,24,MT,수입,8278,150336
2021,8,8,체육대회,지출,1990,148346
2020,10,30,MT,수입,3448,151794
2022,1,19,MT,지출,2377,149417
2023,2,1,MT,지출,4490,144927
2023,4,15,쇼핑,지출,1484,143443
2020,4,12,MT,지출,8999,134444
2022,2,17,식사,수입,3833,138277
2020,6,5,식사,수입,4757,143034
2021,2,28,여행,지출,6495,136539
2021,4,18,MT,지출,5680,130859
2023,3,29,여행,수입,7811,138670
2021,2,12,체육대회,수입,7697,146367
2021,8,15,쇼핑,지출,9502,136865
2023,2,10,식사,지출,3051,133814
2020,3,1,MT,지출,1648,132166
2021,6,19,쇼핑,수입,4702,136868
2021,3,25,식사,수입,1823,138691
2020,1,16,체육대회,지출,3348,135343
2023,11,21,쇼핑,수입,1089,136432
2022,3,11,여행,수입,4974,141406
2020,12,27,식사,수입,8066,149472
2022,6,14,체육대회,수입,1164,150636
2023,11,14,여행,지출,8005,142631
2020,4,20,체육대회,지출,4621,138010
2023,11,25,MT,지출,7950,130060
2021,8,7,체육대회,지출,2263,127797
2021,3,2,MT,지출,2900,124897
2021,9,26,체육대회,수입,9334,134231
2022,2,22,식사,수입,6411,140642
2020,1,25,식사,수입,6202,146844
2023,8,29,체육대회,수입,2991,149835
2022,10,6,체육대회,수입,4357,154192
2020,11,10,체육대회,수입,6181,160373
2023,4,27,MT,지출,2996,157377
2023,2,2,식사,수입,9160,166537
2023,8,7,쇼핑,지출,8783,157754
2022,3,2,식사,수입,7602,165356
2021,9,16,여행,지출,9909,155447
2023,8,2,체육대회,수입,7181,162628
2020,7,17,쇼핑,수입,4459,167087
2022,7,16,여행,수입,5262,172349
2022,10,21,쇼핑,수입,3042,175391
2020,2,16,식사,수입,3371,178762
2023,5,9,쇼핑,수입,9319,188081
2023,11,5,쇼핑,지출,3329,184752
2023,5,6,체육대회,수입,8408,193160
2022,9,18,체육대회,수입,4272,197432
2022,7,18,MT,지출,3539,193893
2020,5,30,쇼핑,지출,8011,185882
2023,7,2,MT,수입,9679,195561
2021,5,20,식사,수입,1829,197390
2022,2,14,체육대회,수입,4480,201870
2021,7,29,쇼핑,수입,6823,208693
2023,5,8,식사,수입,3679,212372
2021,9,4,식사,지출,8087,204285
2021,7,14,쇼핑,수입,5575,209860
2021,10,6,체육대회,수입,3147,213007
2020,6,19,쇼핑,지출,9721,203286
2023,9,27,쇼핑,지출,1065,202221
2023,1,11,체육대회,지출,6673,195548
2023,9,5,체육대회,지출,5819,189729
2023,2,4,MT,수입,4807,194536
2020,4,25,쇼핑,수입,5145,199681
2021,9,18,MT,수입,3282,202963
2023,1,3,쇼핑,수입,7604,210567
2022,1,11,체육대회,수입,4358,214925
2022,9,23,쇼핑,수입,7925,222850
2021,4,1,MT,지출,6044,216806
2022,9,25,여행,지출,5564,211242
2023,10,16,여행,수입,5890,217132
2020,4,3,여행,수입,1725,218857
2021,10,28,쇼핑,수입,2333,221190
2021,12,19,쇼핑,수입,6062,227252
2022,8,24,여행,수입,6258,233510
2021,2,4,쇼핑,수입,1630,235140
2022,9,4,체육대회,지출,5741,229399
2022,8,15,쇼핑,수입,8059,237458
2022,6,25,MT,수입,1601,239059
2023,11,16,쇼핑,지출,8194,230865
2020,6,15,쇼핑,수입,3251,234116
2023,2,12,MT,지출,1181,232935
2020,5,14,식사,수입,1907,234842
2020,6,5,MT,지출,8773,226069
2021,12,20,체육대회,지출,4751,221318
2021,10,30,MT,수입,1444,222762
2023,6,5,식사,수입,6441,229203
2022,7,7,MT,지출,5496,223707
2020,8,30,MT,지출,4398,219309
2020,8,11,식사,수입,6837,226146
2022,5,27,쇼핑,지출,6710,219436
2022,11,28,체육대회,지출,7214,212222
2021,6,20,여행,수입,8470,220692
2023,12,2,쇼핑,수입,3311,224003
2021,8,11,여행,지출,2541,221462
2022,2,8,MT,지출,2094,219368
2023,1,21,쇼핑,지출,8860,210508
2022,7,24,여행,수입,6252,216760
2021,12,12,쇼핑,수입,2399,219159
2023,6,20,여행,지출,9151,210008
2020,6,17,여행,수입,8480,218488
2022,11,15,식사,수입,6695,225183
2020,1,8,MT,지출,1615,223568
2023,10,8,MT,수입,1067,224635
2023,7,16,쇼핑,수입,5678,230313
2022,5,25,식사,지출,9609,220704
2020,9,13,쇼핑,수입,5026,225730
2020,12,7,여행,수입,5663,231393
2023,7,10,체육대회,지출,8678,222715
2022,12,24,체육대회,수입,1485,224200
2023,8,29,여행,수입,3401,227601
2020,10,3,식사,수입,4700,232301
2021,9,24,식사,지출,9363,222938
2022,6,10,쇼핑,지출,3215,219723
2023,10,4,여행,수입,7515,227238
2020,11,30,체육대회,지출,7822,219416
2023,2,21,체육대회,지출,7396,212020
2021,9,20,여행,지출,2697,209323
2021,2,13,체육대회,지출,6240,203083
2020,3,10,식사,수입,2097,205180
2021,1,25,식사,지출,3239,201941
2020,7,13,여행,수입,9192,211133
2022,1,28,체육대회,수입,4427,215560
2023,7,22,쇼핑,지출,6795,208765
2023,9,2,여행,지출,1892,206873
2020,10,13,체육대회,수입,2263,209136
2020,9,8,식사,수입,3129,212265
2020,2,28,체육대회,수입,8824,221089
2023,3,29,식사,수입,9606,230695
2020,12,1,체육대회,수입,9998,240693
2021,4,17,쇼핑,수입,6859,247552
2021,11,18,MT,수입,8300,255852
2021,3,8,여행,수입,3263,259115
2023,8,24,여행,지출,2337,256778
2020,4,30,여행,지출,7379,249399
2020,7,15,식사,수입,8992,258391
2022,11,14,식사,지출,4566,253825
2020,4,6,여행,지출,4475,249350
2020,11,14,여행,수입,9838,259188
2022,7,11,쇼핑,수입,5753,264941
2020,1,4,쇼핑,수입,3555,268496
2023,1,20,체육대회,지출,2865,265631
2022,2,7,식사,지출,2828,262803
2020,1,3,체육대회,지출,1295,261508
2022,3,9,쇼핑,지출,2980,258528
2022,10,6,식사,수입,6975,265503
2020,4,12,식사,지출,2216,263287
2023,5,24,여행,지출,3498,259789
2020,2,29,쇼핑,수입,2883,262672
2021,12,4,쇼핑,지출,6694,255978
2020,2,11,체육대회,지출,7579,248399
2021,8,10,MT,수입,5079,253478
2023,7,20,MT,수입,9046,262524
2022,6,1,여행,지출,7757,254767
2023,9,1,쇼핑,지출,4906,249861
2022,7,12,식사,지출,7050,242811
2021,5,13,여행,지출,3063,239748
2021,1,31,체육대회,수입,5669,245417
2023,3,23,쇼핑,지출,2352,243065
2020,5,22,쇼핑,지출,5615,237450
2020,8,2,체육대회,지출,3506,233944
2021,4,21,식사,지출,2625,231319
2021,11,23,MT,지출,7690,223629
2021,10,29,여행,수입,1040,224669
2020,11,26,여행,지출,5632,219037
2023,4,25,MT,수입,2165,221202
2021,1,7,쇼핑,수입,2083,223285
2022,8,26,MT,지출,2205,221080
2022,7,5,식사,지출,1502,219578
2021,11,15,쇼핑,수입,7988,227566
2021,11,23,식사,수입,5230,232796
2021,4,24,MT,수입,3656,236452
2022,4,30,MT,지출,4841,231611
2021,3,27,쇼핑,지출,2939,228672
2021,7,6,여행,지출,2018,226654
2023,2,14,체육대회,수입,9284,235938
2022,5,22,식사,지출,5811,230127
2021,5,6,MT,지출,7380,222747
2022,9,7,체육대회,수입,1719,224466
2021,2,12,식사,지출,6119,218347
2022,9,13,쇼핑,수입,8007,226354
2021,4,28,여행,지출,4443,221911
2020,1,29,체육대회,수입,1861,223772
2020,2,25,여행,지출,2834,220938
2023,2,28,MT,수입,8158,229096
2022,4,22,식사,수입,2664,231760
2023,10,30,MT,수입,5852,237612
2020,4,8,여행,지출,6945,230667
2021,6,19,쇼핑,수입,4426,235093
2023,12,20,체육대회,수입,9611,244704
2021,11,27,식사,수입,5237,249941
2020,12,25,여행,수입,9995,259936
2023,12,1,MT,수입,8594,268530
2020,2,25,쇼핑,수입,8599,277129
2023,11,21,여행,수입,7322,284451
2020,9,26,여행,수입,9041,293492
2020,9,4,여행,지출,1611,291881
2023,8,21,여행,수입,5445,297326
2021,1,30,쇼핑,지출,6781,290545
2020,5,6,쇼핑,지출,2748,287797
2023,10,16,MT,수입,5091,292888
2021,11,14,MT,수입,2123,295011
2021,12,19,여행,수입,2296,297307
2023,4,10,여행,수입,1432,298739
2022,5,8,식사,지출,6708,292031
2023,12,24,MT,수입,5448,297479
2020,6,9,여행,지출,7530,289949
2020,7,10,여행,지출,4213,285736
2020,12,4,체육대회,수입,4860,290596
2020,8,28,MT,수입,3510,294106
2023,9,13,여행,수입,1221,295327
2022,8,30,체육대회,수입,5240,300567
2021,3,15,식사,지출,1329,299238
2021,1,14,식사,지출,9828,289410
2023,12,3,식사,수입,9942,299352
2021,3,28,체육대회,지출,5727,293625
2022,8,5,MT,지출,8689,284936
2022,9,12,체육대회,수입,6412,291348
2021,11,18,MT,지출,5055,286293
2022,10,3,식사,수입,7049,293342
2021,7,28,쇼핑,지출,5820,287522
2020,6,22,쇼핑,수입,8928,296450
2022,6,27,MT,지출,6389,290061
2022,7,11,쇼핑,지출,5546,284515
2022,9,7,체육대회,수입,5559,290074
2020,7,2,쇼핑,지출,4773,285301
2020,12,21,체육대회,수입,3565,288866
2023,11,8,여행,지출,1267,287599
2020,7,2,쇼핑,수입,5705,293304
2022,7,20,MT,지출,3030,290274
2020,2,25,쇼핑,지출,6571,283703
2021,12,30,식사,수입,2492,286195
2022,9,6,체육대회,지출,5012,281183
2023,11,11,식사,지출,1887,279296
2022,4,10,쇼핑,수입,2695,281991
2021,10,4,체육대회,수입,3586,285577
2020,5,16,쇼핑,수입,3255,288832
2022,12,31,여행,수입,8604,297436
2021,7,28,MT,수입,2844,300280
2021,7,16,쇼핑,수입,8673,308953
2021,7,6,쇼핑,수입,3123,312076
2020,10,14,식사,지출,9839,302237
2021,4,8,체육대회,지출,2599,299638
2022,11,8,MT,수입,6075,305713
2022,11,25,MT,지출,4200,301513
2022,11,19,쇼핑,지출,3117,298396
2020,10,19,MT,지출,8751,289645
2021,1,5,쇼핑,수입,9723,299368
2022,4,10,쇼핑,지출,5524,293844
2023,3,8,식사,수입,5967,299811
2023,8,3,여행,지출,6177,293634
2022,7,24,MT,수입,1193,294827
2020,3,23,MT,수입,2208,297035
2021,3,16,체육대회,수입,5576,302611
2021,1,4,여행,지출,3952,298659
2020,7,24,쇼핑,지출,9233,289426
2020,5,16,쇼핑,지출,5544,283882
2023,1,5,체육대회,수입,6963,290845
2023,2,17,체육대회,지출,3792,287053
2021,9,18,쇼핑,지출,5132,281921
2020,5,4,MT,수입,8068,289989
2020,10,18,쇼핑,지출,7062,282927
2020,7,27,MT,지출,6194,276733
2020,5,29,MT,수입,6647,283380
2021,9,12,쇼핑,지출,3619,279761
2021,12,30,체육대회,지출,5496,274265
2022,11,8,체육대회,수입,2460,276725
2022,12,26,식사,수입,1499,278224
2023,1,21,MT,지출,7737,270487
2021,5,11,체육대회,수입,2500,272987
2022,8,22,체육대회,수입,3204,276191
2023,10,19,MT,수입,9968,286159
2021,6,17,여행,수입,6769,292928
2021,6,25,MT,지출,6019,286909
2022,2,10,체육대회,수입,8825,295734
2020,4,28,식사,수입,9448,305182
2021,12,22,체육대회,지출,9796,295386
2022,9,24,MT,지출,4347,291039
2022,10,25,여행,수입,7862,298901
2021,1,8,MT,지출,6530,292371
2023,3,10,식사,지출,6742,285629
2021,10,29,식사,지출,9578,276051
2023,5,3,쇼핑,지출,8765,267286
2020,5,3,쇼핑,수입,8300,275586
2020,9,26,쇼핑,수입,3879,279465
2022,3,25,체육대회,지출,3427,276038
2020,3,29,여행,수입,2539,278577
2023,4,18,여행,수입,3711,282288
2020,8,1,체육대회,지출,2969,279319
2022,8,20,쇼핑,수입,6359,285678
2021,9,22,쇼핑,지출,8479,277199
2021,7,1,여행,지출,2080,275119
2020,1,16,MT,수입,1805,276924
2022,11,27,쇼핑,지출,1078,275846
2021,1,12,식사,지출,9441,266405
2020,11,1,MT,지출,6364,260041
2022,4,21,식사,수입,8401,268442
2022,9,16,여행,수입,6986,275428
2021,6,24,여행,수입,5483,280911
2023,11,20,MT,지출,1629,279282
2021,1,16,체육대회,수입,9511,288793
2022,3,4,쇼핑,수입,3000,291793
2022,6,24,식사,지출,2246,289547
2020,11,5,쇼핑,수입,1906,291453
2022,4,16,체육대회,수입,6336,297789
2023,9,28,쇼핑,지출,5883,291906
2021,8,3,체육대회,수입,3333,295239
2021,12,24,체육대회,지출,7460,287779
2023,1,14,MT,수입,2370,290149
2023,6,14,식사,수입,7107,297256
2022,3,26,체육대회,지출,1375,295881
2023,1,23,여행,지출,9995,285886
2021,11,29,체육대회,수입,3656,289542
2020,4,16,여행,지출,4134,285408
2020,7,10,식사,수입,7908,293316
2023,6,22,체육대회,수입,6962,300278
2023,10,8,쇼핑,수입,7734,308012
2022,11,22,체육대회,지출,7133,300879
2023,10,19,식사,지출,1981,298898
2022,2,20,식사,지출,4958,293940
2021,2,21,여행,지출,8065,285875
2021,10,22,MT,지출,5543,280332
2022,12,5,여행,수입,8591,288923
2020,2,18,식사,수입,2913,291836
2020,6,4,MT,지출,9426,282410
2021,5,23,여행,지출,2584,279826
2023,5,30,여행,수입,3703,283529
2022,6,5,여행,지출,9572,273957
2021,8,8,여행,지출,1245,272712
2022,3,23,식사,수입,3504,276216
2020,3,11,식사,지출,5626,270590
2021,4,26,쇼핑,지출,1498,269092
2021,11,6,체육대회,수입,9595,278687
2022,9,15,식사,수입,2014,280701
2023,4,12,체육대회,수입,7674,288375
2023,8,13,식사,수입,3144,291519
2023,3,22,식사,지출,9848,281671
2020,6,16,여행,지출,7210,274461
2023,9,13,체육대회,수입,8102,282563
2022,6,7,쇼핑,수입,4517,287080
2021,8,25,쇼핑,지출,7501,279579
2023,3,21,쇼핑,지출,2582,276997
2020,5,13,체육대회,지출,5319,271678
2020,11,24,MT,수입,6997,278675
2020,1,10,체육대회,수입,9978,288653
2023,10,24,식사,지출,3452,285201
2022,4,26,체육대회,수입,8106,293307
2022,2,7,식사,수입,5369,298676
2020,11,27,체육대회,지출,7186,291490
2022,9,18,MT,수입,6098,297588
2022,8,21,여행,수입,4076,301664
2020,8,8,쇼핑,지출,4133,297531
2022,12,20,여행,지출,4084,293447
2022,11,8,여행,지출,1985,291462
2022,3,20,MT,지출,3673,287789
2020,8,30,쇼핑,지출,4935,282854
2021,3,7,여행,수입,9473,292327
2023,5,15,식사,지출,7456,284871
2021,7,2,여행,지출,1768,283103
2023,8,25,체육대회,수입,6791,289894
2022,8,1,체육대회,수입,6277,296171
2022,5,31,MT,지출,6201,289970
2023,8,10,여행,수입,4596,294566
2020,3,12,MT,지출,9625,284941
2020,11,3,여행,수입,1495,286436
2022,4,5,MT,수입,8474,294910
2022,7,3,체육대회,수입,9176,304086
2020,1,10,체육대회,지출,8029,296057
2020,9,14,MT,지출,2452,293605
2022,6,2,쇼핑,지출,3213,290392
2023,9,7,MT,지출,4155,286237
2023,5,20,여행,수입,5707,291944
2020,10,12,체육대회,수입,3976,295920
2022,4,14,쇼핑,지출,7476,288444
2022,12,14,체육대회,수입,6507,294951
2023,4,23,여행,수입,2369,297320
2023,7,11,MT,지출,6703,290617
2022,10,29,MT,지출,3054,287563
2020,6,21,MT,지출,8410,279153
2022,11,25,여행,지출,3620,275533
2023,3,8,체육대회,지출,9490,266043
2023,12,21,쇼핑,수입,5708,271751
2023,12,11,쇼핑,지출,8170,263581
2020,7,29,MT,수입,7531,271112
2020,8,20,MT,지출,3069,268043
2022,7,1,MT,수입,9045,277088
2020,5,2,쇼핑,수입,3488,280576
2021,2,23,체육대회,지출,8250,272326
2020,7,31,MT,수입,1813,274139
2023,6,22,체육대회,수입,2943,277082
2021,8,4,체육대회,지출,4716,272366
2020,5,6,식사,지출,1313,271053
2020,8,20,MT,지출,6149,264904
2023,6,18,체육대회,지출,8668,256236
2022,6,22,식사,지출,7265,248971
2021,10,14,여행,수입,3345,252316
2020,3,31,MT,지출,5054,247262
2021,2,1,체육대회,지출,7526,239736
2022,8,13,체육대회,지출,1939,237797
2023,5,15,MT,지출,8216,229581
2023,7,24,식사,지출,7415,222166
2021,5,20,식사,지출,7297,214869
2022,12,4,쇼핑,지출,3048,211821
2021,2,10,여행,지출,5690,206131
2022,10,4,식사,수입,8187,214318
2021,1,1,여행,수입,6673,220991
2020,6,2,쇼핑,지출,2536,218455
2020,11,29,여행,지출,8932,209523
2022,10,15,쇼핑,지출,9303,200220
2023,7,19,쇼핑,수입,3668,203888
2022,10,31,체육대회,지출,5790,198098
2020,4,29,여행,수입,3407,201505
2022,5,23,MT,지출,7411,194094
2023,3,18,여행,수입,9491,203585
2023,4,24,MT,지출,5556,198029
2023,11,15,여행,수입,5592,203621
2021,11,6,식사,지출,7673,195948
2023,2,28,여행,지출,6376,189572
2022,2,5,식사,수입,4387,193959
2020,6,13,체육대회,지출,3937,190022
2022,2,3,MT,지출,5718,184304
2022,8,15,여행,지출,3328,180976
2022,3,14,쇼핑,수입,6001,186977
2020,1,6,쇼핑,수입,5793,192770
2021,5,12,쇼핑,수입,4614,197384
2022,8,8,식사,수입,5032,202416
2023,9,23,MT,지출,8690,193726
2023,5,15,MT,수입,2295,196021
2023,11,4,체육대회,지출,4484,191537
2023,11,11,식사,수입,4647,196184
2023,11,29,여행,지출,5377,190807
2021,10,23,체육대회,수입,8466,199273
2021,6,17,여행,수입,5469,204742
2020,2,3,쇼핑,수입,2593,207335
2022,1,8,MT,지출,8736,198599
2021,11,30,여행,지출,8903,189696
2021,8,21,체육대회,지출,4492,185204
2023,7,19,MT,지출,8092,177112
2022,4,23,MT,지출,2988,174124
2020,10,25,여행,지출,4613,169511
2023,2,7,여행,수입,4610,174121
2023,3,17,MT,수입,9771,183892
2021,2,13,식사,수입,8391,192283
2021,2,12,MT,수입,9690,201973
2023,4,3,MT,수입,3004,204977
2021,9,4,체육대회,지출,9428,195549
2020,12,6,쇼핑,지출,9929,185620
2023,7,19,쇼핑,수입,1911,187531
2021,3,12,여행,수입,6503,194034
2023,2,7,체육대회,지출,9701,184333
2023,2,18,식사,수입,5637,189970
2022,11,15,MT,수입,8882,198852
2023,5,23,체육대회,지출,2339,196513
2022,1,6,식사,수입,5415,201928
2020,10,19,쇼핑,지출,5175,196753
2020,7,12,쇼핑,지출,5469,191284
2023,4,26,쇼핑,수입,7678,198962
2020,4,16,MT,지출,9931,189031
2023,11,17,여행,지출,4737,184294
2022,2,13,MT,지출,8147,176147
2022,7,11,체육대회,수입,2692,178839
2021,2,27,식사,지출,5905,172934
2020,12,18,여행,수입,7876,180810
2020,4,27,식사,수입,2837,183647
2022,6,4,체육대회,수입,4358,188005
2023,10,2,여행,지출,7911,180094
2022,5,19,여행,수입,6266,186360
2023,3,16,체육대회,지출,4026,182334
2021,12,4,MT,수입,2156,184490
2023,8,2,체육대회,수입,5924,190414
2020,10,9,체육대회,지출,2794,187620
2022,10,11,체육대회,수입,7342,194962
2022,6,5,여행,지출,7544,187418
2020,5,17,여행,수입,6014,193432
2021,6,1,여행,수입,8231,201663
2023,8,6,쇼핑,지출,1476,200187
2023,1,27,식사,수입,5008,205195
2022,9,21,MT,수입,7564,212759
2023,1,2,MT,지출,5489,207270
2023,1,5,식사,수입,4172,211442
2023,1,10,여행,수입,9959,221401
2022,12,26,쇼핑,지출,4484,216917
2023,9,30,식사,수입,7063,223980
2021,3,9,식사,수입,6321,230301
2023,1,19,식사,지출,3548,226753
2022,8,16,체육대회,수입,4752,231505
2021,4,18,체육대회,지출,5001,226504
2020,3,19,체육대회,수입,8740,235244
2021,7,23,MT,수입,5800,241044
2020,8,13,식사,지출,6577,234467
2020,1,23,MT,지출,8234,226233
2022,11,1,MT,지출,4710,221523
2020,8,1,체육대회,지출,8121,213402
2022,10,15,여행,지출,5757,207645
2023,2,18,체육대회,수입,4835,212480
2023,2,14,여행,수입,4144,216624
2020,3,31,쇼핑,지출,7143,209481
2023,6,17,식사,수입,7158,216639
2023,10,30,식사,수입,2480,219119
2020,6,16,체육대회,지출,1637,217482
2020,9,9,MT,수입,2187,219669
2022,12,27,체육대회,수입,8470,228139
2023,2,13,식사,수입,8538,236677
2021,12,3,체육대회,지출,5193,231484
2022,9,5,MT,수입,9897,241381
2023,5,12,여행,지출,8024,233357
2022,9,27,식사,수입,8624,241981
2020,11,26,MT,수입,7603,249584
2023,12,7,체육대회,지출,7130,242454
2021,9,13,체육대회,수입,5989,248443
2023,10,19,쇼핑,지출,6265,242178
2022,10,17,MT,수입,6424,248602
2020,1,14,MT,수입,5820,254422
2023,1,21,식사,지출,8324,246098
2021,8,3,쇼핑,지출,6759,239339
2021,6,27,쇼핑,지출,2899,236440
2021,8,24,MT,지출,8483,227957
2022,3,10,체육대회,수입,3464,231421
2021,10,3,식사,지출,1399,230022
2020,1,25,식사,수입,7791,237813
2020,6,20,식사,지출,4297,233516
2020,9,12,쇼핑,수입,8238,241754
2020,9,2,쇼핑,수입,7823,249577
2020,2,27,식사,지출,3606,245971
2022,7,15,식사,수입,4765,250736
2021,10,27,MT,수입,7139,257875
2023,2,26,MT,수입,7549,265424
2022,2,15,식사,지출,7522,257902
2021,2,4,여행,지출,4522,253380
2023,5,12,MT,지출,6726,246654
2023,1,19,MT,수입,8248,254902
2022,11,14,체육대회,지출,6483,248419
2020,6,20,여행,지출,9515,238904
2021,1,29,쇼핑,지출,6288,232616
2023,11,10,체육대회,수입,3238,235854
2023,11,9,체육대회,수입,3988,239842
2023,3,24,식사,지출,3097,236745
2023,5,16,쇼핑,수입,9021,245766
2021,8,29,여행,수입,9892,255658
2023,10,10,체육대회,지출,6799,248859
2023,2,13,체육대회,수입,6395,255254
2020,8,13,체육대회,지출,2258,252996
2023,6,15,MT,지출,8226,244770
2023,4,9,체육대회,수입,7405,252175
2022,11,1,여행,지출,2464,249711
2022,2,20,쇼핑,수입,4371,254082
2020,9,24,식사,수입,7706,261788
2020,8,14,체육대회,수입,3877,265665
2023,11,13,쇼핑,수입,2500,268165
2023,4,14,체육대회,지출,3575,264590
2022,7,24,식사,지출,2516,262074
2020,11,10,체육대회,지출,6113,255961
2020,7,8,여행,수입,1227,257188
2022,3,16,여행,수입,2707,259895
2022,12,26,여행,지출,4665,255230
2021,6,28,MT,지출,2788,252442
2021,9,16,MT,수입,8789,261231
2023,3,29,식사,수입,7356,268587
2023,4,24,여행,수입,9848,278435
2023,10,10,MT,수입,2171,280606
2022,1,24,MT,지출,3553,277053
2021,11,4,식사,지출,8158,268895
2021,2,12,체육대회,수입,9007,277902
2022,9,23,쇼핑,수입,7152,285054
2022,5,30,식사,수입,8405,293459
2022,8,4,여행,수입,6372,299831
2023,7,18,식사,수입,7474,307305
2023,10,28,쇼핑,지출,1385,305920
2022,12,28,식사,지출,3682,302238
2021,3,1,MT,수입,6490,308728
2021,3,31,체육대회,지출,7557,301171
2022,6,9,MT,수입,6160,307331
2020,11,6,MT,지출,2125,305206
2021,3,13,쇼핑,수입,3583,308789
2023,7,23,쇼핑,지출,6444,302345
2023,6,23,쇼핑,수입,8601,310946
2022,3,17,여행,지출,5781,305165
2021,1,29,쇼핑,지출,6330,298835
2022,6,27,MT,수입,7010,305845
2021,5,5,체육대회,수입,8192,314037
2020,9,23,쇼핑,지출,8557,305480
2023,6,16,식사,수입,9348,314828
2021,5,12,MT,수입,6118,320946
2021,8,30,MT,지출,6154,314792
2022,12,20,체육대회,수입,5836,320628
2023,7,26,쇼핑,수입,9893,330521
2023,2,10,MT,지출,2384,328137
2020,4,27,식사,수입,6148,334285
2022,3,13,쇼핑,지출,7427,326858
2020,1,7,MT,수입,8157,335015
2023,6,22,쇼핑,수입,6064,341079
2020,11,6,쇼핑,수입,2176,343255
2020,5,19,MT,수입,6299,349554
2021,2,26,체육대회,수입,7526,357080
2023,12,2,MT,지출,6046,351034
2022,9,3,식사,수입,6984,358018
2022,1,18,MT,지출,9203,348815
2021,6,30,여행,수입,1828,350643
2022,10,22,MT,지출,1631,349012
2021,3,25,쇼핑,지출,8001,341011
2021,3,8,식사,지출,9056,331955
2021,7,6,체육대회,지출,1938,330017
2023,8,27,식사,지출,5551,324466
2020,4,19,여행,수입,2945,327411
2020,5,24,식사,지출,8526,318885
2020,9,17,쇼핑,수입,8109,326994
2021,1,27,여행,지출,3685,323309
2020,9,3,여행,지출,6429,316880
2021,5,2,쇼핑,지출,2507,314373
2023,4,5,여행,지출,8793,305580
2022,7,15,여행,수입,3143,308723
2021,8,22,여행,지출,9142,299581
2023,12,11,MT,지출,2360,297221
2023,1,13,MT,수입,9864,307085
2023,3,5,식사,수입,7816,314901
2020,12,16,식사,지출,4562,310339
2020,4,29,MT,지출,7365,302974
2023,11,14,여행,지출,3719,299255
2023,1,21,MT,수입,5191,304446
2020,7,10,체육대회,지출,3812,300634
2022,7,21,여행,수입,9130,309764
2020,11,3,체육대회,지출,2379,307385
2021,7,22,체육대회,지출,1095,306290
2021,7,20,MT,지출,9615,296675
2023,1,24,쇼핑,수입,1923,298598
2022,10,6,MT,지출,7618,290980
2020,11,27,MT,지출,6390,284590
2021,2,22,쇼핑,수입,2504,287094
2022,11,26,쇼핑,지출,7111,279983
2020,12,25,여행,지출,1385,278598
2021,11,14,식사,지출,2280,276318
2023,6,16,식사,지출,1100,275218
2023,2,9,MT,지출,3121,272097
2022,7,2,MT,수입,4717,276814
2023,3,14,MT,지출,2663,274151
2022,1,29,MT,지출,8912,265239
2022,8,12,식사,지출,1763,263476
2023,12,13,쇼핑,지출,8822,254654
2020,6,2,식사,지출,3542,251112
2022,6,22,쇼핑,수입,1605,252717
2023,3,5,MT,지출,6632,246085
2020,5,19,MT,지출,2259,243826
2022,4,6,MT,지출,3066,240760
2023,1,30,MT,지출,8302,232458
2021,8,19,식사,수입,5000,237458
2021,5,14,식사,수입,6715,244173
2021,1,15,식사,수입,6136,250309
2023,8,15,체육대회,지출,1239,249070
2022,8,27,여행,수입,1428,250498
2023,6,10,쇼핑,수입,2022,252520
2022,8,20,쇼핑,수입,6717,259237
2022,7,24,쇼핑,수입,6220,265457
2023,9,29,식사,지출,9185,256272
2022,3,7,식사,수입,8659,264931
2022,2,11,체육대회,수입,3652,268583
2020,5,20,여행,수입,6467,275050
2021,10,19,MT,수입,2493,277543
2021,4,21,체육대회,지출,2163,275380
2021,2,25,쇼핑,지출,6106,269274
2023,2,24,식사,수입,8566,277840
2021,9,22,식사,지출,6450,271390
2021,2,11,체육대회,지출,8819,262571
2023,1,20,여행,지출,9783,252788
2020,12,30,MT,수입,5167,257955
2020,5,23,여행,지출,6963,250992
2020,5,12,여행,지출,4097,246895
2021,8,22,여행,지출,1773,245122
2023,8,12,여행,수입,4427,249549
2023,9,26,쇼핑,수입,1983,251532
2023,5,18,MT,지출,5647,245885
2020,10,22,여행,수입,7640,253525
2022,4,21,체육대회,수입,8542,262067
2021,9,20,여행,지출,4226,257841
2020,3,10,MT,수입,6134,263975
2020,7,27,식사,지출,9349,254626
2022,2,22,쇼핑,지출,5109,249517
2021,8,20,여행,수입,8170,257687
2023,1,2,여행,지출,8633,249054
2022,11,18,체육대회,지출,6044,243010
2023,10,15,여행,지출,9589,233421
2021,4,2,식사,수입,5602,239023
2020,1,31,쇼핑,지출,6666,232357
2021,2,18,체육대회,지출,5646,226711
2022,2,4,쇼핑,수입,7139,233850
2020,1,22,MT,수입,3461,237311
2023,4,23,쇼핑,지출,5453,231858
2023,12,18,식사,수입,4960,236818
2022,4,28,쇼핑,수입,3459,240277
2022,12,17,MT,수입,4718,244995
2020,8,21,MT,지출,6818,238177
2021,11,4,쇼핑,수입,7858,246035
2022,10,27,여행,수입,1869,247904
2022,5,12,식사,지출,3772,244132
2020,11,9,여행,수입,3943,248075
2023,9,14,여행,수입,2825,250900
2021,4,30,쇼핑,지출,2666,248234
2023,8,14,여행,지출,4275,243959
2022,9,17,쇼핑,지출,6651,237308
2022,7,6,식사,수입,2750,240058
2023,10,7,MT,지출,2877,237181
2020,7,16,여행,지출,8110,229071
2022,1,5,체육대회,지출,4248,224823
2021,8,16,식사,수입,3500,228323
2020,8,24,식사,지출,7941,220382
2020,3,21,식사,지출,1764,218618
2020,1,20,쇼핑,수입,1913,220531
2023,7,24,식사,지출,4212,216319
2020,10,19,쇼핑,수입,7281,223600
2020,5,28,식사,지출,1747,221853
2022,11,22,식사,수입,4760,226613
2021,10,21,여행,지출,3504,223109
2020,5,15,MT,수입,6567,229676
2022,10,15,여행,지출,1884,227792
2022,1,14,체육대회,수입,5573,233365
2020,7,12,식사,수입,1518,234883
2021,1,29,쇼핑,지출,9718,225165
2022,12,20,여행,수입,8036,233201
2020,10,18,여행,수입,2442,235643
2021,7,1,MT,수입,7060,242703
2021,8,26,체육대회,수입,8729,251432
2022,1,26,MT,지출,2623,248809
2021,5,21,MT,수입,7705,256514
2021,5,27,쇼핑,수입,5371,261885
2020,7,26,여행,지출,5264,256621
2020,7,28,MT,수입,5647,262268
2022,4,7,여행,지출,2823,259445
2022,4,20,MT,지출,1336,258109
2021,4,16,MT,지출,2256,255853
2020,10,26,식사,수입,8086,263939
2020,6,13,체육대회,수입,6686,270625
2021,2,18,여행,지출,2237,268388
2020,5,27,쇼핑,지출,8641,259747
2022,7,4,쇼핑,지출,6702,253045
2022,11,10,체육대회,지출,6697,246348
2020,10,2,MT,수입,3535,249883
2021,6,11,여행,수입,7860,257743
2023,4,26,쇼핑,수입,1505,259248
2021,5,21,식사,수입,4721,263969
2022,9,25,체육대회,지출,2533,261436
2020,4,26,식사,지출,7993,253443
2023,7,12,쇼핑,지출,8936,244507
2022,3,15,쇼핑,수입,4003,248510
2021,11,20,쇼핑,수입,3480,251990
2021,9,27,체육대회,지출,4227,247763
2020,3,13,여행,지출,8592,239171
2022,3,19,쇼핑,수입,3829,243000
2023,7,31,식사,수입,8990,251990
2020,8,12,식사,수입,1474,253464
2023,5,22,쇼핑,지출,3325,250139
2022,10,11,여행,지출,8595,241544
2020,7,18,체육대회,지출,8993,232551
2022,4,6,쇼핑,지출,3390,229161
2023,1,1,식사,수입,3403,232564
2023,8,21,MT,수입,3637,236201
2022,10,6,식사,수입,3488,239689
2021,7,26,체육대회,지출,6802,232887
2020,6,7,체육대회,지출,8915,223972
2020,10,30,체육대회,지출,3479,220493
2023,12,8,MT,지출,8445,212048
2022,9,7,여행,수입,2947,214995
2022,3,21,MT,지출,7065,207930
2021,12,11,식사,수입,5279,213209
2022,1,30,MT,수입,4328,217537
2021,3,24,식사,수입,4363,221900
2020,12,2,식사,지출,8966,212934
2022,1,29,쇼핑,수입,5915,218849
2021,9,21,여행,수입,3264,222113
2022,1,28,여행,수입,2437,224550
2023,5,2,식사,수입,7953,232503
2021,8,27,쇼핑,수입,4327,236830
2020,2,18,식사,지출,8779,228051
2022,8,15,체육대회,수입,9870,237921
2023,6,18,여행,지출,7176,230745
2021,8,30,체육대회,지출,5011,225734
2023,7,31,체육대회,수입,9018,234752
2021,7,6,식사,지출,3308,231444
2020,3,9,여행,지출,4195,227249
2022,3,6,식사,지출,3697,223552
2023,10,6,쇼핑,수입,6006,229558
2020,5,24,식사,지출,3513,226045
2020,5,12,여행,지출,1454,224591
2023,3,23,MT,지출,4768,219823
2020,3,9,여행,수입,3828,223651
2022,4,25,식사,수입,4134,227785
2020,3,23,MT,지출,6621,221164
2021,2,5,여행,수입,5824,226988
2020,2,23,식사,수입,3655,230643
2021,9,7,쇼핑,수입,2503,233146
2020,3,3,식사,수입,6119,239265
2022,2,20,쇼핑,수입,2380,241645
2022,4,12,쇼핑,수입,5634,247279
2020,11,26,MT,지출,6623,240656
2022,11,2,쇼핑,수입,3000,243656
2021,5,24,체육대회,수입,9653,253309
2020,3,23,MT,지출,6247,247062
2020,6,3,쇼핑,지출,4614,242448
2020,7,8,식사,지출,8316,234132
2023,3,1,여행,수입,7714,241846
2022,10,29,체육대회,지출,5664,236182
2021,3,30,식사,지출,3076,233106
2020,11,13,체육대회,수입,3008,236114
2020,7,12,여행,수입,8493,244607
2023,6,4,쇼핑,수입,9666,254273
2021,3,23,쇼핑,수입,7333,261606
2021,5,18,쇼핑,수입,9008,270614
2021,3,16,쇼핑,지출,6690,263924
2020,4,11,여행,수입,4647,268571
2020,8,24,체육대회,지출,8805,259766
2022,9,24,쇼핑,지출,9460,250306
2023,9,16,여행,지출,4623,245683
2023,12,18,MT,수입,1547,247230
2021,10,11,여행,수입,2991,250221
2021,12,16,체육대회,지출,3505,246716
2022,7,26,여행,지출,1638,245078
2023,9,12,쇼핑,지출,7855,237223
2023,12,4,체육대회,지출,6484,230739
2023,2,2,체육대회,수입,7085,237824
2020,11,27,여행,수입,9194,247018
2021,11,26,식사,수입,4753,251771
2020,2,27,체육대회,수입,9354,261125
2023,7,8,여행,지출,1745,259380
2020,8,27,쇼핑,지출,1708,257672
2022,5,9,여행,수입,4123,261795
2020,12,17,여행,지출,5209,256586
2023,4,21,쇼핑,수입,2810,259396
2023,1,7,체육대회,지출,1913,257483
2023,10,20,식사,수입,5760,263243
2023,5,17,체육대회,수입,8334,271577
2020,10,14,체육대회,수입,3837,275414
2020,6,1,식사,지출,7420,267994
2023,9,27,쇼핑,수입,1321,269315
2021,12,27,쇼핑,수입,2298,271613
2021,10,3,식사,수입,2757,274370
2020,8,1,체육대회,지출,2126,272244
2021,6,26,쇼핑,지출,4262,267982
2020,8,6,쇼핑,수입,3649,271631
2021,7,29,체육대회,수입,8075,279706
2020,1,2,MT,수입,8402,288108
2021,9,10,MT,수입,3981,292089
2020,2,6,여행,수입,2628,294717
2020,9,15,쇼핑,수입,6592,301309
2022,2,18,여행,지출,8128,293181
2023,5,9,여행,수입,7523,300704
2022,4,4,여행,지출,8661,292043
2020,4,7,여행,지출,3139,288904
2022,3,10,쇼핑,지출,4669,284235
2021,4,15,식사,지출,8604,275631
2022,2,13,MT,지출,1645,273986
2022,12,25,쇼핑,지출,8874,265112
2021,7,12,MT,수입,8262,273374
2023,3,5,여행,수입,9820,283194
2020,1,6,MT,지출,4126,279068
2022,9,4,체육대회,지출,2088,276980
2023,4,11,체육대회,지출,4365,272615
2021,6,22,여행,수입,6235,278850
2023,8,21,MT,지출,5097,273753
2022,12,10,쇼핑,수입,4962,278715
2022,3,18,식사,수입,9029,287744
2023,8,9,식사,지출,3761,283983
2023,9,24,식사,지출,8904,275079
2022,8,8,체육대회,지출,7290,267789
2023,2,3,식사,지출,1332,266457
2020,3,1,MT,지출,7564,258893
2023,6,26,체육대회,지출,2514,256379
2023,12,4,여행,지출,7398,248981
2020,1,23,식사,지출,5006,243975
2021,7,16,체육대회,수입,9103,253078
2020,2,26,MT,지출,7311,245767
2023,12,13,체육대회,지출,4328,241439
2020,4,14,식사,수입,5723,247162
2022,7,18,여행,수입,3838,251000
2020,4,8,MT,수입,1676,252676
2020,5,17,여행,수입,1741,254417
2022,11,23,여행,지출,6689,247728
2020,10,14,여행,수입,7930,255658
2022,6,15,여행,수입,1907,257565
2023,2,20,MT,수입,4688,262253
2021,3,31,여행,지출,2242,260011
2022,3,27,식사,수입,5756,265767
2020,11,30,식사,수입,2737,268504
2021,10,15,체육대회,수입,7813,276317
2022,2,11,쇼핑,수입,7351,283668
2022,10,23,쇼핑,수입,3746,287414
2020,2,4,식사,지출,8270,279144
2021,12,7,MT,지출,7037,272107
2021,6,6,쇼핑,수입,7123,279230
2023,7,13,쇼핑,수입,7807,287037
2023,8,1,MT,지출,1935,285102
2023,5,3,MT,수입,2057,287159
2020,4,2,여행,지출,9510,277649
2022,8,17,MT,지출,8516,269133
2020,6,4,쇼핑,수입,4171,273304
2022,7,16,식사,지출,9916,263388
2020,8,13,식사,수입,5559,268947
2020,10,16,체육대회,지출,4296,264651
2020,1,27,식사,수입,1831,266482
2021,6,30,쇼핑,수입,1814,268296
2020,10,10,쇼핑,지출,3013,265283
2021,12,23,여행,수입,5903,271186
2023,12,12,체육대회,수입,4458,275644
2023,5,8,쇼핑,수입,6842,282486
2023,6,27,여행,지출,7721,274765
2021,3,4,여행,지출,8803,265962
2021,11,22,식사,지출,8331,257631
2021,12,8,체육대회,지출,9419,248212
2022,1,3,체육대회,지출,8616,239596
2023,7,2,여행,수입,9932,249528
2020,9,27,여행,지출,7185,242343
2021,5,13,MT,지출,8649,233694
2020,2,19,쇼핑,지출,9287,224407
2023,2,2,쇼핑,수입,7990,232397
2023,8,9,체육대회,지출,4582,227815
2022,11,9,여행,수입,1148,228963
2023,3,8,식사,지출,5375,223588
2021,11,15,식사,수입,2346,225934
2020,11,30,여행,지출,3778,222156
2021,9,19,식사,수입,9744,231900
2021,11,1,여행,지출,5753,226147
2022,5,14,식사,수입,9291,235438
2020,10,17,MT,지출,1544,233894
2023,12,19,식사,수입,1649,235543
2021,2,15,체육대회,수입,6993,242536
2022,6,23,식사,수입,2518,245054
2023,6,16,MT,수입,7427,252481
2022,1,2,체육대회,지출,3092,249389
2021,10,4,여행,수입,2482,251871
2021,3,1,식사,지출,1506,250365
2020,11,6,MT,지출,9849,240516
2020,7,26,식사,지출,3596,236920
2020,10,1,여행,수입,8677,245597
2020,7,3,여행,수입,1301,246898
2023,4,4,체육대회,지출,9020,237878
2020,5,9,MT,수입,6808,244686
2023,2,6,여행,수입,4115,248801
2020,10,23,체육대회,수입,8334,257135
2020,11,24,여행,수입,4415,261550
2020,11,5,쇼핑,수입,7047,268597
2022,12,7,여행,수입,2086,270683
2022,4,5,식사,수입,7437,278120
2023,2,17,MT,수입,9209,287329
2022,1,14,식사,수입,2525,289854
2023,10,28,여행,수입,6464,296318
2020,1,26,체육대회,수입,3536,299854
2021,8,20,쇼핑,수입,6723,306577
2023,9,5,식사,지출,9706,296871
2022,7,30,식사,수입,6782,303653
2021,7,18,식사,지출,7333,296320
2022,3,25,식사,지출,4742,291578
2022,8,10,쇼핑,수입,2556,294134
2023,12,31,쇼핑,수입,2809,296943
2020,8,10,체육대회,수입,4405,301348
2021,10,5,MT,수입,7127,308475
2020,9,3,쇼핑,수입,8405,316880
2021,5,19,여행,지출,4995,311885
2021,11,7,MT,지출,6152,305733
2020,2,19,식사,수입,8790,314523
2022,6,24,MT,지출,4181,310342
2022,6,28,MT,수입,2101,312443
2023,10,11,여행,수입,7150,319593
2022,8,6,체육대회,지출,7714,311879
2022,8,9,체육대회,수입,7791,319670
2023,7,3,쇼핑,지출,4614,315056
2021,12,31,쇼핑,지출,1484,313572
2023,1,5,식사,수입,1542,315114
2022,1,23,쇼핑,수입,3517,318631
2023,11,29,체육대회,지출,9725,308906
2023,7,11,체육대회,지출,9192,299714
2023,10,13,쇼핑,지출,7122,292592
2023,11,13,MT,지출,7973,284619
2020,7,10,쇼핑,수입,5290,289909
2020,12,22,MT,지출,9031,280878
2023,10,22,여행,수입,6810,287688
2022,6,26,여행,수입,2941,290629
2022,2,18,쇼핑,지출,9217,281412
2023,3,25,여행,지출,1952,279460
2020,8,29,쇼핑,지출,3898,275562
2021,4,26,식사,수입,9176,284738
2021,7,13,쇼핑,수입,3135,287873
2021,11,28,여행,수입,4836,292709
2021,4,19,식사,수입,4097,296806
2023,3,29,식사,지출,4240,292566
2020,8,2,여행,지출,8906,283660
2020,1,30,쇼핑,지출,3488,280172
2022,10,30,여행,지출,4550,275622
2020,2,10,쇼핑,수입,4810,280432
2021,5,29,체육대회,지출,6237,274195
2021,10,6,식사,수입,6738,280933
2020,1,1,체육대회,수입,9585,290518
2021,3,14,식사,지출,5824,284694
2023,6,8,쇼핑,수입,9175,293869
2023,4,9,여행,수입,5663,299532
2023,10,27,쇼핑,수입,5148,304680
2020,4,14,체육대회,지출,1342,303338
2021,10,26,식사,수입,7807,311145
2022,3,6,MT,지출,7796,303349
2021,6,3,MT,수입,8308,311657
2022,4,21,식사,지출,3063,308594
2023,2,21,체육대회,수입,6150,314744
2021,5,10,식사,지출,6704,308040
2020,3,15,체육대회,수입,2262,310302
2022,10,15,식사,수입,6965,317267
2020,1,2,체육대회,수입,8893,326160
2023,1,22,여행,지출,1241,324919
2022,5,19,식사,수입,7232,332151
2022,8,25,쇼핑,수입,4154,336305
2022,2,22,식사,수입,7998,344303
2021,11,11,식사,지출,5504,338799
2021,8,21,식사,지출,5406,333393
2020,5,18,체육대회,수입,3559,336952
2023,4,3,쇼핑,수입,1849,338801
2023,11,20,쇼핑,지출,8224,330577
2020,4,11,체육대회,수입,7230,337807
2021,11,23,식사,수입,8599,346406
2023,12,21,쇼핑,수입,5532,351938
2023,7,6,쇼핑,수입,6794,358732
2020,8,12,식사,수입,4182,362914
2023,11,22,쇼핑,수입,1799,364713
2020,8,6,체육대회,지출,9206,355507
2022,4,11,여행,지출,5397,350110
2023,11,14,여행,수입,7439,357549
2021,2,10,여행,지출,8203,349346
2023,3,23,체육대회,수입,3695,353041
2020,1,21,체육대회,지출,7921,345120
2021,6,15,식사,지출,9464,335656
2022,1,4,체육대회,지출,7667,327989
2023,7,31,체육대회,지출,5276,322713
2022,2,17,식사,수입,1713,324426
2023,1,20,체육대회,수입,4115,328541
2022,5,4,쇼핑,수입,3660,332201
2021,12,21,MT,수입,6911,339112
2023,10,9,MT,지출,3918,335194
2021,8,16,체육대회,지출,1527,333667
2021,3,13,MT,수입,1741,335408
2020,12,20,쇼핑,지출,9027,326381
2022,5,12,체육대회,지출,4644,321737
2022,11,5,여행,수입,5270,327007
2021,7,8,체육대회,수입,7908,334915
2023,2,20,체육대회,수입,5051,339966
2020,6,24,쇼핑,지출,1354,338612
2022,8,17,식사,지출,5172,333440
2021,2,4,쇼핑,지출,5552,327888
2020,5,6,MT,지출,4256,323632
2021,8,11,여행,지출,9372,314260
2023,6,16,쇼핑,지출,9225,305035
2021,4,20,여행,지출,5357,299678
2020,10,12,식사,수입,9812,309490
2021,2,20,체육대회,지출,4025,305465
2021,2,21,식사,지출,7966,297499
2020,11,14,쇼핑,지출,4105,293394
2021,1,15,식사,수입,6485,299879
2022,12,16,체육대회,지출,3940,295939
2021,1,18,식사,수입,1797,297736
2020,12,11,MT,지출,5787,291949
2021,12,29,여행,지출,3612,288337
2023,8,12,식사,수입,1230,289567
2023,8,15,MT,수입,6097,295664
2020,3,6,식사,지출,5977,289687
2020,12,24,식사,지출,4389,285298
2023,12,21,쇼핑,지출,2042,283256
2021,10,7,체육대회,지출,1984,281272
2023,7,26,여행,수입,9751,291023
2022,2,26,여행,지출,2455,288568
2022,4,20,체육대회,지출,7338,281230
2021,9,15,여행,지출,5027,276203
2023,12,9,MT,지출,8329,267874
2020,1,3,MT,지출,9939,257935
2020,7,24,여행,지출,5316,252619
2021,6,5,여행,수입,7621,260240
2023,7,28,여행,지출,6982,253258
2022,3,17,MT,수입,1955,255213
2023,7,27,식사,지출,4287,250926
2022,4,20,MT,지출,6344,244582
2023,1,20,식사,수입,8354,252936
2023,2,9,MT,지출,7309,245627
2020,12,18,체육대회,수입,4773,250400
2022,8,10,체육대회,수입,3181,253581
2023,4,13,쇼핑,수입,2308,255889
2022,2,23,체육대회,지출,9751,246138
2020,3,29,MT,수입,8615,254753
2021,8,7,식사,지출,6829,247924
2020,5,28,식사,지출,5533,242391
2023,3,2,쇼핑,지출,2399,239992
2021,1,26,MT,수입,7434,247426
2023,5,24,식사,수입,7255,254681
2023,10,13,식사,수입,2456,257137
2021,6,21,식사,수입,8570,265707
2020,8,12,여행,수입,9131,274838
2022,8,12,식사,지출,9712,265126
2023,1,30,체육대회,지출,3618,261508
2020,3,8,식사,수입,9827,271335
2020,8,14,쇼핑,지출,3142,268193
2022,12,19,쇼핑,수입,6436,274629
2022,1,6,식사,수입,3715,278344
2022,12,25,쇼핑,수입,7020,285364
2021,7,3,체육대회,지출,1098,284266
2020,6,8,쇼핑,수입,4626,288892
2023,2,6,식사,지출,8093,280799
2021,8,31,MT,지출,7176,273623
2022,7,11,식사,수입,7413,281036
2020,8,2,식사,지출,2121,278915
2020,10,18,체육대회,지출,9699,269216
2020,8,25,식사,지출,9825,259391
2020,12,9,여행,수입,5166,264557
2021,1,1,쇼핑,수입,9471,274028
2021,12,31,쇼핑,수입,1034,275062
2022,12,17,체육대회,지출,4579,270483
2022,11,25,쇼핑,지출,4286,266197
2020,11,14,쇼핑,수입,5220,271417
2023,2,21,여행,수입,6102,277519
2022,8,15,식사,지출,6682,270837
2021,5,27,여행,지출,8134,262703
2022,4,28,MT,지출,6923,255780
2023,10,18,쇼핑,수입,3953,259733
2021,1,13,여행,수입,8076,267809
2020,5,20,체육대회,지출,6108,261701
2020,4,30,식사,지출,5686,256015
2021,8,22,체육대회,수입,2640,258655
2022,3,10,식사,수입,5434,264089
2021,12,25,쇼핑,지출,2316,261773
2021,7,14,여행,지출,2248,259525
2020,1,31,여행,수입,7961,267486
2021,3,12,쇼핑,수입,5836,273322
2023,1,28,식사,지출,1248,272074
2020,3,21,식사,지출,9894,262180
2020,7,17,체육대회,지출,8027,254153
2022,12,3,쇼핑,지출,9552,244601
2020,2,19,쇼핑,지출,6449,238152
2023,5,17,쇼핑,지출,1152,237000
2023,3,4,체육대회,지출,5460,231540
2023,4,18,여행,지출,7492,224048
2022,6,7,식사,지출,8890,215158
2020,10,21,여행,지출,8431,206727
2022,12,11,체육대회,수입,8731,215458
2022,3,11,MT,수입,9969,225427
2021,8,20,식사,수입,6098,231525
2022,3,13,MT,지출,4761,226764
2023,1,10,여행,수입,2941,229705
2022,4,9,체육대회,지출,5516,224189
2021,9,27,쇼핑,지출,6497,217692
2023,3,23,여행,수입,3143,220835
2023,11,6,체육대회,지출,2037,218798
2023,1,20,MT,수입,1219,220017
2021,9,4,여행,지출,2125,217892
2023,8,11,여행,지출,6715,211177
2022,5,11,쇼핑,지출,3238,207939
2023,9,17,식사,지출,4535,203404
2020,10,24,체육대회,지출,3270,200134
2022,12,22,쇼핑,지출,6217,193917
2021,4,22,식사,지출,8714,185203
2020,8,1,쇼핑,지출,1246,183957
2022,7,14,체육대회,수입,6717,190674
2021,9,16,체육대회,지출,7513,183161
2022,11,4,식사,지출,2968,180193
2023,10,8,MT,지출,7342,172851
2023,3,6,식사,수입,8268,181119
2020,7,24,MT,지출,4802,176317
2022,11,9,쇼핑,수입,6893,183210
2020,12,1,쇼핑,지출,3827,179383
2021,9,26,식사,수입,6873,186256
2020,5,12,MT,지출,4834,181422
2023,11,1,MT,지출,2883,178539
2023,5,13,MT,지출,1188,177351
2023,10,5,여행,수입,9855,187206
2022,11,2,쇼핑,수입,9941,197147
2022,12,19,체육대회,수입,2653,199800
2022,11,11,쇼핑,수입,6286,206086
2020,8,14,쇼핑,수입,8574,214660
2020,9,2,쇼핑,지출,7447,207213
2022,3,17,식사,지출,9308,197905
2023,8,3,식사,수입,4030,201935
2022,10,31,쇼핑,수입,8861,210796
2023,7,22,MT,수입,8047,218843
2022,2,17,MT,지출,5059,213784
2023,6,3,MT,지출,3531,210253
2021,6,14,쇼핑,수입,5986,216239
2021,7,22,체육대회,수입,9241,225480
2023,4,20,체육대회,수입,6046,231526
2020,10,13,식사,수입,2110,233636
2021,1,15,MT,지출,6397,227239
2021,9,19,식사,수입,4494,231733
2023,12,31,식사,수입,4746,236479
2021,1,7,여행,수입,7188,243667
2023,7,2,체육대회,지출,3773,239894
2023,2,1,MT,수입,4548,244442
2022,6,14,쇼핑,수입,9322,253764
2023,5,25,여행,지출,7833,245931
2023,9,12,여행,수입,9778,255709
2022,1,13,쇼핑,지출,1250,254459
2023,2,5,여행,지출,8258,246201
2021,9,30,체육대회,수입,3896,250097
2023,7,17,여행,수입,5847,255944
2023,8,21,쇼핑,수입,2736,258680
2021,5,2,식사,지출,7144,251536
2022,9,27,여행,수입,5453,256989
2022,11,8,쇼핑,수입,3633,260622
2020,3,18,식사,지출,4228,256394
2022,12,21,여행,수입,7096,263490
2023,6,19,체육대회,수입,8806,272296
2023,4,26,여행,수입,3689,275985
2021,9,6,MT,수입,4021,280006
2023,8,6,MT,지출,6086,273920
2021,8,9,식사,지출,3096,270824
2022,9,9,여행,수입,4661,275485
2023,5,26,여행,지출,4128,271357
2020,4,27,MT,수입,5586,276943
2020,11,18,여행,수입,9110,286053
2022,2,16,체육대회,지출,7936,278117
2020,2,10,식사,수입,7966,286083
2023,10,21,체육대회,수입,6726,292809
2021,7,20,여행,수입,3318,296127
2021,6,30,쇼핑,수입,6106,302233
2023,9,9,식사,지출,3411,298822
2023,11,23,식사,수입,4434,303256
2020,12,15,식사,수입,7124,310380
2021,10,12,MT,지출,7681,302699
2023,3,7,MT,지출,5666,297033
2021,4,27,쇼핑,수입,6404,303437
2023,8,22,여행,지출,2848,300589
2022,9,24,여행,지출,1649,298940
2022,7,12,여행,지출,9383,289557
2022,11,8,쇼핑,수입,4819,294376
2022,6,27,MT,지출,5654,288722
2023,11,27,체육대회,수입,9243,297965
2020,3,14,여행,수입,3884,301849
2020,10,31,여행,지출,8630,293219
2021,4,13,쇼핑,지출,9896,283323
2021,4,24,쇼핑,수입,7748,291071
2020,6,1,체육대회,지출,5110,285961
2023,2,18,여행,수입,7989,293950
2020,12,30,여행,지출,7123,286827
2022,1,22,식사,수입,3709,290536
2020,1,14,MT,지출,1495,289041
2022,1,23,여행,지출,7858,281183
2020,5,12,식사,수입,7474,288657
2020,2,26,여행,지출,2790,285867
2021,8,13,여행,수입,5392,291259
2022,9,26,여행,지출,5148,286111
2022,6,4,쇼핑,수입,5227,291338
2023,3,20,MT,지출,2154,289184
2020,11,3,식사,지출,7490,281694
2021,10,16,체육대회,지출,1705,279989
2023,3,31,쇼핑,수입,1461,281450
2021,1,6,체육대회,수입,2970,284420
2021,4,5,식사,지출,6806,277614
2023,10,14,체육대회,지출,6532,271082
2022,9,25,식사,지출,1817,269265
2022,7,3,MT,수입,5190,274455
2023,8,1,여행,지출,8388,266067
2022,5,28,체육대회,수입,8616,274683
2023,2,10,쇼핑,지출,5207,269476
2020,6,21,체육대회,수입,6699,276175
2020,1,2,MT,수입,5154,281329
2021,12,2,쇼핑,지출,9676,271653
2022,8,30,여행,수입,4396,276049
2020,1,7,쇼핑,지출,9038,267011
2020,1,31,쇼핑,수입,4258,271269
2022,2,24,체육대회,수입,3559,274828
2020,4,6,체육대회,수입,6442,281270
2023,10,10,체육대회,수입,7614,288884
2022,8,31,체육대회,수입,9033,297917
2023,3,22,MT,지출,3417,294500
2023,7,3,체육대회,수입,1904,296404
2020,11,22,쇼핑,지출,9582,286822
2022,9,17,체육대회,수입,4766,291588
2020,2,28,쇼핑,수입,6038,297626
2020,1,9,여행,지출,5821,291805
2021,9,16,식사,수입,3937,295742
2020,12,14,MT,지출,9544,286198
2023,1,9,MT,지출,3387,282811
2022,11,25,쇼핑,수입,3030,285841
2023,1,20,MT,지출,6320,279521
2020,11,11,쇼핑,지출,1127,278394
2021,6,26,체육대회,수입,2541,280935
2023,6,10,식사,지출,9171,271764
2021,10,29,체육대회,수입,7671,279435
2020,1,28,체육대회,지출,4772,274663
2020,6,22,쇼핑,지출,6519,268144
2022,5,11,여행,수입,5354,273498
2021,3,26,체육대회,수입,6709,280207
2022,2,20,MT,지출,5214,274993
2021,9,19,체육대회,지출,2131,272862
2023,11,28,식사,수입,8300,281162
2021,2,28,쇼핑,수입,4498,285660
2020,6,12,MT,수입,3046,288706
2023,12,6,체육대회,수입,3018,291724
2022,2,22,식사,지출,3601,288123
2023,1,28,여행,수입,2127,290250
2023,7,4,여행,수입,7074,297324
2020,9,29,식사,수입,8093,305417
2023,9,29,식사,지출,9082,296335
2023,11,16,식사,수입,2529,298864
2022,5,31,MT,지출,8545,290319
2021,3,19,식사,지출,3853,286466
2021,11,22,쇼핑,수입,4014,290480
2020,10,29,여행,수입,2175,292655
2023,8,28,MT,수입,4893,297548
2022,4,5,체육대회,지출,6015,291533
2022,11,20,쇼핑,수입,7390,298923
2020,1,20,여행,수입,7384,306307
2021,4,4,쇼핑,지출,6795,299512
2020,9,26,체육대회,지출,4099,295413
2022,1,21,식사,수입,8187,303600
2023,11,2,MT,수입,1253,304853
2020,12,13,식사,수입,1149,306002
2023,11,24,MT,수입,5524,311526
2022,2,23,식사,지출,2150,309376
2020,5,13,MT,수입,3501,312877
2023,4,4,쇼핑,지출,5775,307102
2023,2,20,쇼핑,수입,1792,308894
2022,3,7,쇼핑,수입,8978,317872
2022,10,20,여행,지출,5032,312840
2023,7,4,MT,지출,6056,306784
2022,1,8,식사,지출,3781,303003
2021,1,22,식사,지출,9100,293903
2021,10,11,체육대회,지출,5447,288456
2020,6,3,체육대회,지출,9324,279132
2023,1,22,MT,지출,9182,269950
2023,8,20,MT,수입,5317,275267
2023,11,23,체육대회,수입,2324,277591
2023,10,4,식사,수입,8707,286298
2022,9,25,체육대회,지출,5139,281159
2020,8,24,MT,수입,6051,287210
2020,5,1,체육대회,지출,8407,278803
2023,12,28,여행,수입,9677,288480
2020,9,16,쇼핑,지출,3944,284536
2021,8,7,MT,수입,7536,292072
2023,8,9,식사,지출,7937,284135
2022,5,2,쇼핑,수입,8911,293046
2021,10,21,MT,수입,9842,302888
2022,12,27,여행,수입,2129,305017
2020,1,6,쇼핑,수입,5541,310558
2021,11,8,체육대회,수입,6374,316932
2022,10,3,여행,지출,7222,309710
2021,1,14,체육대회,수입,7052,316762
2021,8,25,식사,지출,9531,307231
2021,3,6,쇼핑,수입,5651,312882
2023,8,31,체육대회,수입,5408,318290
2023,4,14,여행,지출,5180,313110
2021,2,28,쇼핑,지출,7548,305562
2021,7,5,식사,수입,1308,306870
2021,4,22,여행,지출,1746,305124
2022,2,24,체육대회,수입,1400,306524
2022,5,23,MT,수입,4243,310767
2020,1,20,여행,수입,6404,317171
2022,5,3,여행,지출,7125,310046
2021,7,29,MT,수입,8627,318673
2021,5,25,여행,지출,9323,309350
2020,6,26,식사,수입,4011,313361
2021,3,16,식사,지출,8818,304543
2020,4,13,체육대회,수입,4664,309207
2021,5,17,체육대회,수입,3334,312541
2021,6,7,쇼핑,지출,7067,305474
2022,2,21,식사,지출,5532,299942
2022,2,22,식사,지출,3554,296388
2023,6,19,MT,수입,1416,297804
2022,9,12,여행,수입,8420,306224
2020,11,4,MT,지출,9671,296553
2020,2,29,MT,지출,2290,294263
2021,12,22,식사,지출,9220,285043
2021,9,5,쇼핑,수입,5956,290999
2022,11,25,식사,수입,8460,299459
2022,11,26,체육대회,수입,4440,303899
2021,3,5,쇼핑,수입,8804,312703
2023,10,13,MT,수입,4357,317060
2021,3,30,체육대회,지출,9406,307654
2023,11,2,체육대회,지출,5375,302279
2023,4,25,체육대회,지출,9822,292457
2023,4,2,식사,지출,7067,285390
2020,10,1,체육대회,수입,4520,289910
2022,4,27,쇼핑,수입,9676,299586
2022,3,4,MT,지출,1565,298021
2020,5,12,MT,수입,1747,299768
2023,11,11,체육대회,수입,6449,306217
2022,7,26,식사,지출,3053,303164
2021,6,1,여행,지출,9601,293563
2020,1,12,식사,수입,8538,302101
2021,3,8,체육대회,지출,3970,298131
2020,6,30,여행,수입,6409,304540
2022,12,25,체육대회,지출,4532,300008
2021,11,20,MT,지출,6033,293975
2020,3,15,쇼핑,수입,3199,297174
2020,7,8,여행,수입,7787,304961
2022,7,16,쇼핑,지출,8010,296951
2023,4,25,쇼핑,수입,7997,304948
2023,4,8,쇼핑,수입,9345,314293
2021,3,20,식사,수입,2675,316968
2023,4,15,MT,수입,6966,323934
2021,9,29,여행,지출,5150,318784
2021,9,28,MT,수입,6415,325199
2023,3,11,식사,지출,4701,320498
2020,7,7,여행,지출,3376,317122
2021,6,1,여행,수입,8339,325461
2020,8,4,쇼핑,수입,3045,328506
2020,4,4,여행,지출,3601,324905
2021,9,30,여행,지출,5232,319673
2021,2,26,여행,수입,5007,324680
2020,2,28,쇼핑,지출,9839,314841
2020,4,23,쇼핑,지출,9286,305555
2021,8,15,MT,지출,3124,302431
2023,11,10,쇼핑,수입,7381,309812
2020,12,13,식사,수입,1647,311459
2021,6,4,MT,지출,9317,302142
2023,7,25,쇼핑,수입,1501,303643
2022,4,22,체육대회,지출,1635,302008
2023,8,31,쇼핑,수입,7893,309901
2022,2,27,식사,수입,6344,316245
2021,5,5,쇼핑,수입,6023,322268
2023,5,27,여행,수입,5361,327629
2021,4,18,체육대회,지출,3276,324353
2023,10,6,체육대회,지출,3329,321024
2022,7,4,여행,수입,8093,329117
2020,9,20,쇼핑,수입,8951,338068
2022,1,12,체육대회,지출,2920,335148
2022,7,7,MT,수입,8739,343887
2022,8,3,식사,수입,5051,348938
2020,4,25,식사,지출,3524,345414
2022,1,13,식사,지출,2055,343359
2022,7,8,MT,지출,1087,342272
2020,5,24,체육대회,수입,2037,344309
2023,12,14,식사,지출,8200,336109
2023,9,14,식사,지출,9708,326401
2020,8,7,체육대회,수입,5062,331463
2023,5,17,여행,수입,5598,337061
2021,11,7,체육대회,수입,3400,340461
2020,9,20,쇼핑,수입,7845,348306
2020,10,11,여행,지출,8523,339783
2022,7,27,식사,수입,8194,347977
2020,12,12,쇼핑,수입,9729,357706
2022,8,17,쇼핑,수입,2905,360611
2020,11,16,MT,수입,3092,363703
2020,6,21,여행,지출,6715,356988
2021,7,2,식사,지출,5528,351460
2021,12,29,체육대회,지출,9556,341904
2023,11,7,MT,수입,6800,348704
2020,11,1,여행,지출,6657,342047
2020,3,16,MT,수입,5537,347584
2022,10,2,여행,지출,7298,340286
2023,2,12,식사,수입,2972,343258
2023,6,23,체육대회,지출,3260,339998
2022,11,29,여행,수입,3160,343158
2021,11,6,식사,수입,8196,351354
2023,4,13,여행,지출,5579,345775
2023,10,31,여행,수입,1141,346916
2020,11,23,여행,지출,9141,337775
2023,1,9,MT,수입,4200,341975
2023,5,1,식사,지출,6135,335840
2022,12,26,체육대회,지출,8176,327664
2020,10,1,체육대회,수입,2354,330018
2021,6,3,체육대회,지출,6356,323662
2022,10,11,체육대회,수입,9057,332719
2020,4,1,쇼핑,수입,4387,337106
2021,10,25,식사,수입,7552,344658
2023,12,15,체육대회,지출,3876,340782
2021,1,3,체육대회,지출,7931,332851
2023,5,1,MT,수입,4815,337666
2023,9,15,여행,수입,2811,340477
2023,2,23,쇼핑,지출,3541,336936
2021,6,25,여행,수입,6240,343176
2021,12,14,여행,수입,7343,350519
2023,7,11,쇼핑,수입,2960,353479
2020,10,25,식사,수입,5158,358637
2021,5,28,여행,지출,1015,357622
2021,7,10,식사,수입,2716,360338
2022,5,23,MT,수입,6650,366988
2023,7,4,쇼핑,지출,9101,357887
2023,1,6,식사,지출,8469,349418
2020,8,7,MT,지출,1438,347980
2020,8,31,식사,지출,8315,339665
2021,7,14,체육대회,지출,2662,337003
2021,10,23,식사,지출,9271,327732
2022,7,13,체육대회,지출,3419,324313
2023,10,14,식사,수입,9631,333944
2021,10,26,여행,수입,1867,335811
2023,5,30,여행,지출,2750,333061
2022,12,11,식사,지출,7086,325975
2022,7,29,식사,지출,2945,323030
2023,4,13,식사,수입,6368,329398
2020,11,2,체육대회,지출,3774,325624
2022,9,25,여행,지출,3002,322622
2023,12,24,체육대회,수입,7414,330036
2023,9,29,MT,지출,9447,320589
2023,3,14,체육대회,지출,1326,319263
2022,9,18,MT,지출,1140,318123
2020,5,9,여행,수입,2310,320433
2023,4,15,식사,지출,6846,313587
2022,9,2,체육대회,수입,3016,316603
2023,2,7,체육대회,지출,6159,310444
2020,12,10,체육대회,수입,5831,316275
2020,8,7,MT,지출,9379,306896
2023,12,29,체육대회,수입,9173,316069
2021,6,20,MT,수입,6654,322723
2022,10,14,여행,지출,7071,315652
2020,10,11,식사,지출,8322,307330
2020,12,23,쇼핑,수입,5388,312718
2020,1,2,MT,수입,4959,317677
2022,3,13,MT,지출,9921,307756
2021,1,4,MT,수입,5812,313568
2021,5,16,체육대회,지출,8460,305108
2023,11,25,식사,수입,5194,310302
2020,2,7,여행,수입,2334,312636
2023,8,23,체육대회,수입,3977,316613
2022,5,12,체육대회,수입,8334,324947
2021,5,13,식사,지출,3724,321223
2023,2,27,식사,지출,9744,311479
2020,10,11,MT,수입,6494,317973
2023,9,15,여행,지출,3391,314582
2021,8,27,체육대회,수입,6098,320680
2023,9,29,MT,지출,9978,310702
2022,8,8,체육대회,지출,5230,305472
2022,11,22,MT,수입,6503,311975
2021,8,28,쇼핑,지출,4245,307730
2022,2,10,MT,수입,4456,312186
2023,11,24,쇼핑,수입,2711,314897
2022,10,28,MT,수입,7178,322075
2022,12,11,MT,수입,5483,327558
2023,10,28,식사,수입,7180,334738
2020,2,17,MT,지출,3121,331617
2022,9,7,체육대회,수입,2586,334203
2023,5,31,여행,수입,9649,343852
2020,2,24,여행,지출,1521,342331
2020,6,21,여행,지출,3562,338769
2020,12,26,식사,지출,5204,333565
2020,12,20,체육대회,지출,2626,330939
2023,2,3,체육대회,지출,7187,323752
2020,3,28,여행,수입,2508,326260
2023,6,17,쇼핑,지출,3467,322793
2020,8,31,여행,수입,4274,327067
2023,10,22,MT,지출,7336,319731
2021,10,2,식사,수입,9547,329278
2022,8,10,식사,지출,2793,326485
2020,4,6,식사,수입,7535,334020
2021,9,25,MT,지출,7452,326568
2022,12,29,식사,지출,5921,320647
2022,11,1,MT,지출,1016,319631
2022,10,5,쇼핑,수입,8236,327867
2022,4,24,여행,수입,8020,335887
2021,12,16,식사,지출,9353,326534
2021,7,12,식사,지출,4272,322262
2020,7,17,식사,지출,2927,319335
2020,6,11,체육대회,수입,5648,324983
2021,3,29,식사,지출,7556,317427
2020,9,11,MT,지출,9555,307872
2022,8,11,쇼핑,지출,4733,303139
2022,8,28,체육대회,지출,9076,294063
2022,5,23,여행,지출,6436,287627
2021,10,20,MT,지출,5697,281930
2020,10,26,쇼핑,지출,1211,280719
2020,10,14,MT,지출,5630,275089
2021,2,28,체육대회,수입,5755,280844
2022,12,16,MT,지출,1791,279053
2023,7,11,체육대회,수입,1168,280221
2021,6,11,쇼핑,지출,7671,272550
2021,10,30,쇼핑,지출,4992,267558
2022,2,16,식사,지출,3219,264339
2020,5,18,체육대회,수입,7323,271662
2023,3,6,MT,수입,1293,272955
2021,8,26,여행,수입,6559,279514
2021,5,19,여행,수입,7254,286768
2022,2,17,MT,수입,5832,292600
2021,7,13,체육대회,지출,9875,282725
2020,12,20,식사,지출,8548,274177
2020,12,20,여행,지출,5955,268222
2022,10,25,쇼핑,지출,2029,266193
2021,4,12,쇼핑,수입,6484,272677
2021,10,8,식사,지출,6660,266017
2023,5,30,여행,지출,1158,264859
2020,6,30,식사,수입,8083,272942
2021,3,13,식사,지출,8735,264207
2022,11,6,체육대회,지출,7232,256975
2021,4,21,여행,지출,1712,255263
2023,5,2,체육대회,수입,4738,260001
2022,1,6,쇼핑,수입,6709,266710
2023,4,12,여행,수입,5548,272258
2020,9,11,여행,수입,8946,281204
2020,1,20,쇼핑,수입,4400,285604
2022,1,26,여행,지출,5619,279985
2022,3,22,식사,지출,9584,270401
2020,11,28,여행,지출,1461,268940
2021,9,11,쇼핑,수입,6494,275434
2020,8,11,식사,지출,4963,270471
2023,9,23,체육대회,수입,6363,276834
2023,7,17,식사,지출,4396,272438
2023,9,5,여행,지출,1098,271340
2022,1,10,쇼핑,수입,1035,272375
2023,8,5,쇼핑,수입,5720,278095
2022,7,5,식사,수입,8402,286497
2022,9,29,식사,지출,9722,276775
2023,11,19,식사,지출,9825,266950
2020,7,3,체육대회,지출,8956,257994
2022,1,13,체육대회,수입,8864,266858
2023,3,4,체육대회,지출,7791,259067
2023,7,26,식사,지출,7385,251682
2021,2,28,쇼핑,지출,7454,244228
2022,2,6,식사,지출,2943,241285
2020,7,3,여행,지출,9208,232077
2022,4,16,MT,수입,6631,238708
2022,12,25,체육대회,지출,2972,235736
2020,11,15,MT,수입,1196,236932
2020,4,15,체육대회,수입,3548,240480
2023,9,26,MT,수입,3876,244356
2020,3,11,식사,수입,7477,251833
2022,7,11,여행,수입,4466,256299
2023,7,5,체육대회,지출,1163,255136
2023,9,22,체육대회,지출,4455,250681
2023,10,20,MT,지출,1939,248742
2022,12,3,체육대회,지출,6122,242620
2021,5,12,체육대회,지출,5867,236753
2021,1,26,쇼핑,수입,8524,245277
2021,4,26,체육대회,지출,7808,237469
2021,8,22,쇼핑,수입,6745,244214
2021,6,30,식사,지출,7925,236289
2020,6,5,MT,수입,9404,245693
2022,7,22,식사,지출,5207,240486
2023,2,10,MT,지출,2776,237710
2022,6,22,체육대회,지출,4354,233356
2020,8,13,MT,지출,6027,227329
2021,11,23,MT,지출,3148,224181
2021,1,11,체육대회,지출,8511,215670
2022,3,4,여행,지출,9450,206220
2021,6,10,여행,지출,1059,205161
2021,12,1,쇼핑,수입,8625,213786
2020,1,27,여행,지출,8081,205705
2022,8,10,MT,수입,8161,213866
2023,9,30,MT,수입,3796,217662
2022,11,23,여행,수입,2472,220134
2023,12,21,식사,수입,6328,226462
2021,10,26,MT,지출,6670,219792
2020,6,14,쇼핑,수입,4731,224523
2020,6,2,체육대회,지출,2154,222369
2023,8,3,쇼핑,수입,3492,225861
2020,11,29,여행,수입,3168,229029
2020,11,26,여행,지출,2792,226237
2021,1,17,식사,지출,3260,222977
2022,1,4,MT,지출,2706,220271
2023,7,18,쇼핑,지출,9051,211220
2021,8,9,식사,지출,9551,201669
2020,11,23,여행,수입,5964,207633
2022,11,15,체육대회,지출,7199,200434
2020,6,27,MT,지출,4122,196312
2023,8,24,여행,수입,6245,202557
2021,3,5,식사,지출,1435,201122
2022,1,22,MT,지출,5616,195506
2021,9,23,MT,수입,9695,205201
2023,2,28,쇼핑,수입,7687,212888
2020,4,21,여행,수입,6278,219166
2022,2,17,식사,수입,1439,220605
2020,12,31,식사,수입,7918,228523
2023,1,11,체육대회,지출,9964,218559
2022,7,1,여행,지출,9228,209331
2021,6,13,쇼핑,수입,7133,216464
2022,1,6,여행,지출,9802,206662
2020,8,2,체육대회,수입,4793,211455
2022,2,20,체육대회,지출,2071,209384
2022,1,8,MT,지출,7338,202046
2020,10,23,여행,수입,2112,204158
2020,12,10,쇼핑,지출,8887,195271
2021,11,8,여행,수입,6605,201876
2021,7,16,쇼핑,지출,4623,197253
2022,11,26,체육대회,지출,8438,188815
2023,6,16,식사,지출,8798,180017
2023,10,11,체육대회,지출,9564,170453
2020,1,24,체육대회,지출,5816,164637
2020,10,19,식사,지출,8168,156469
2021,7,8,식사,수입,2431,158900
2021,10,24,쇼핑,수입,3395,162295
2022,1,18,체육대회,수입,6632,168927
2020,2,27,MT,지출,7110,161817
2021,12,1,쇼핑,수입,8856,170673
2022,3,26,여행,수입,4464,175137
2020,5,26,여행,수입,1457,176594
2021,10,31,여행,수입,5551,182145
2023,1,29,쇼핑,수입,2862,185007
2021,4,8,식사,수입,5003,190010
2021,4,11,식사,수입,9252,199262
2020,9,6,체육대회,수입,3804,203066
2022,10,28,여행,수입,1128,204194
2023,6,23,MT,수입,9737,213931
2022,10,2,식사,지출,2149,211782
2021,3,6,MT,지출,8620,203162
2023,4,1,MT,수입,1336,204498
2021,8,31,여행,수입,1794,206292
2021,2,17,MT,지출,6919,199373
2023,12,7,식사,지출,7718,191655
2023,2,27,여행,지출,5083,186572
2020,8,9,쇼핑,지출,1093,185479
2022,2,15,MT,지출,3093,182386
2023,11,26,체육대회,지출,5310,177076
2020,7,16,MT,수입,5856,182932
2022,9,21,체육대회,수입,5696,188628
2023,2,1,여행,지출,1215,187413
2023,4,23,여행,지출,5771,181642
2022,2,1,여행,수입,2683,184325
2023,1,27,체육대회,지출,3269,181056
2023,5,30,식사,수입,6565,187621
2020,5,28,식사,지출,1376,186245
2020,1,18,MT,수입,4890,191135
2023,7,4,체육대회,지출,1695,189440
2020,4,23,MT,수입,7801,197241
2022,2,14,MT,지출,7853,189388
2021,10,15,쇼핑,수입,8731,198119
2020,3,22,여행,수입,9873,207992
2022,9,10,쇼핑,지출,7893,200099
2022,3,19,쇼핑,지출,2651,197448
2023,12,14,여행,지출,1529,195919
2023,7,24,여행,수입,9040,204959
2021,10,20,체육대회,수입,4920,209879
2022,4,28,식사,수입,8367,218246
2021,11,23,여행,지출,5372,212874
2020,3,24,체육대회,수입,3718,216592
2022,2,28,쇼핑,수입,5064,221656
2022,3,13,MT,지출,1568,220088
2023,2,17,식사,지출,5742,214346
2020,12,2,체육대회,지출,2148,212198
2020,12,19,여행,지출,4712,207486
2022,5,26,식사,수입,3835,211321
2020,9,22,식사,수입,2688,214009
2020,10,30,여행,지출,4898,209111
2020,7,8,여행,수입,9512,218623
2023,7,21,식사,지출,4189,214434
2022,7,5,식사,지출,9296,205138
2023,4,9,MT,지출,4488,200650
2023,8,11,MT,수입,5645,206295
2022,7,21,쇼핑,수입,6991,213286
2023,1,31,여행,지출,5358,207928
2022,4,29,쇼핑,지출,4322,203606
2021,8,3,식사,수입,4013,207619
2021,3,11,식사,수입,6136,213755
2023,6,22,MT,수입,4223,217978
2022,5,10,여행,수입,4256,222234
2022,8,10,MT,지출,4070,218164
2021,9,14,식사,지출,8243,209921
2023,10,12,체육대회,지출,6254,203667
2023,10,4,MT,수입,6736,210403
2021,2,15,체육대회,수입,9081,219484
2021,10,22,MT,지출,3976,215508
2023,10,24,식사,지출,2943,212565
2022,3,16,MT,수입,7947,220512
2020,1,3,식사,수입,5913,226425
2023,4,27,체육대회,지출,1412,225013
2021,8,8,여행,지출,9362,215651
2021,12,16,쇼핑,지출,8535,207116
2021,12,25,쇼핑,수입,8658,215774
2020,5,12,식사,지출,9694,206080
2022,6,5,체육대회,지출,7080,199000
2023,9,16,MT,수입,1909,200909
2022,1,17,식사,지출,6799,194110
2021,4,8,쇼핑,수입,4059,198169
2020,10,23,MT,수입,9844,208013
2023,5,4,식사,수입,9271,217284
2023,1,18,쇼핑,지출,8237,209047
2021,5,28,여행,수입,1614,210661
2022,4,20,여행,지출,6756,203905
2020,10,28,여행,지출,8065,195840
2021,10,14,식사,수입,4123,199963
2023,8,9,MT,지출,9464,190499
2020,10,12,여행,수입,2274,192773
2021,6,8,체육대회,수입,5824,198597
2022,6,16,MT,수입,3101,201698
2020,5,29,식사,수입,8232,209930
2023,3,27,식사,수입,4127,214057
2023,6,8,MT,지출,3382,210675
2023,6,24,여행,지출,4116,206559
2021,3,25,쇼핑,지출,8491,198068
2021,10,14,체육대회,수입,7099,205167
2022,8,8,쇼핑,수입,1052,206219
2022,8,9,체육대회,수입,9108,215327
2020,4,13,체육대회,지출,4895,210432
2021,4,17,쇼핑,수입,4568,215000
2021,10,4,체육대회,수입,2590,217590
2023,7,18,식사,수입,5571,223161
2023,11,1,여행,수입,4351,227512
2020,3,21,쇼핑,수입,7503,235015
2021,2,16,쇼핑,지출,8494,226521
2021,1,14,식사,수입,2533,229054
2023,11,29,여행,지출,2758,226296
2020,11,18,체육대회,지출,5845,220451
2021,4,5,체육대회,지출,4020,216431
2020,7,18,MT,수입,8952,225383
2023,2,28,MT,수입,7895,233278
2021,8,7,체육대회,수입,7712,240990
2021,5,13,쇼핑,지출,2709,238281
2023,3,21,여행,지출,9917,228364
2020,5,31,MT,지출,7950,220414
2020,1,8,체육대회,지출,4096,216318
2022,7,29,MT,지출,3400,212918
2022,1,9,식사,지출,7225,205693
2020,12,26,MT,지출,6179,199514
2022,10,22,여행,지출,6094,193420
2022,4,7,체육대회,수입,4536,197956
2023,7,20,여행,수입,6504,204460
2022,4,16,여행,지출,2406,202054
2022,1,5,쇼핑,지출,5943,196111
2021,4,18,여행,지출,2361,193750
2020,1,21,체육대회,수입,7346,201096
2021,2,22,쇼핑,지출,5714,195382
2020,4,6,식사,수입,7049,202431
2020,10,28,식사,지출,2293,200138
2023,2,7,MT,지출,9323,190815
2020,6,10,여행,지출,8963,181852
2023,11,15,MT,수입,7064,188916
2021,3,16,쇼핑,지출,1490,187426
2021,12,1,식사,수입,6696,194122
2022,12,28,여행,수입,6477,200599
2022,4,17,쇼핑,지출,9433,191166
2022,6,8,쇼핑,지출,4119,187047
2021,12,14,쇼핑,수입,9831,196878
2020,10,26,식사,수입,6453,203331
2023,10,26,식사,수입,2366,205697
2023,1,27,MT,지출,4076,201621
2023,12,8,MT,지출,1798,199823
2023,6,18,MT,수입,4216,204039
2023,10,27,식사,수입,7443,211482
2022,5,26,식사,지출,6669,204813
2021,2,15,여행,수입,1657,206470
2020,10,28,쇼핑,지출,5237,201233
2021,9,27,식사,수입,8751,209984
2023,9,4,MT,지출,1120,208864
2023,10,17,여행,지출,7618,201246
2023,9,22,체육대회,수입,6062,207308
2021,2,9,식사,지출,5947,201361
2021,2,28,식사,지출,8247,193114
2023,8,14,식사,수입,4432,197546
2023,1,3,여행,지출,6192,191354
2022,8,15,쇼핑,지출,7653,183701
2021,4,4,체육대회,수입,4179,187880
2021,4,25,쇼핑,수입,3176,191056
2021,12,11,식사,수입,9611,200667
2023,1,15,식사,지출,9932,190735
2021,9,2,MT,수입,9180,199915
2020,10,5,쇼핑,수입,5050,204965
2022,6,28,MT,지출,3007,201958
2021,9,26,쇼핑,수입,2500,204458
2021,6,11,쇼핑,지출,1911,202547
2021,4,10,식사,수입,7006,209553
2020,6,28,MT,지출,1398,208155
2023,9,21,체육대회,수입,4747,212902
2020,2,27,식사,지출,7161,205741
2020,9,29,MT,지출,3977,201764
2023,2,7,MT,수입,9340,211104
2023,3,19,쇼핑,수입,9764,220868
2021,11,14,여행,수입,7216,228084
2022,5,19,식사,지출,6732,221352
2021,1,22,체육대회,수입,8395,229747
2020,6,25,쇼핑,지출,7147,222600
2023,3,23,여행,수입,6649,229249
2022,9,28,체육대회,지출,2325,226924
2020,5,9,쇼핑,수입,4522,231446
2023,4,19,MT,지출,2471,228975
2020,12,31,여행,지출,4490,224485
2020,9,21,쇼핑,지출,4177,220308
2022,1,28,여행,수입,9766,230074
2022,2,8,MT,지출,9622,220452
2021,12,24,쇼핑,지출,6657,213795
2022,11,9,쇼핑,지출,9425,204370
2021,11,29,쇼핑,수입,8666,213036
2023,9,16,체육대회,수입,4456,217492
2022,5,7,쇼핑,수입,1210,218702
2020,6,6,쇼핑,지출,1921,216781
2022,6,15,쇼핑,지출,9087,207694
2021,8,24,MT,지출,4179,203515
2023,4,25,쇼핑,지출,2433,201082
2022,12,12,식사,수입,7394,208476
2023,7,26,체육대회,수입,4123,212599
2022,8,7,여행,지출,8897,203702
2020,5,28,쇼핑,지출,4123,199579
2020,6,12,식사,수입,7981,207560
2023,4,13,MT,지출,3053,204507
2021,9,3,여행,지출,1444,203063
2023,6,20,식사,지출,9629,193434
2023,9,7,여행,지출,8400,185034
2021,12,19,MT,수입,5404,190438
2022,5,2,MT,지출,6783,183655
2020,4,5,쇼핑,수입,5546,189201
2020,10,28,체육대회,지출,1514,187687
2020,10,29,쇼핑,지출,2531,185156
2021,2,17,쇼핑,수입,7586,192742
2021,2,3,여행,지출,8180,184562
2023,1,18,MT,수입,3069,187631
2021,4,2,여행,지출,5496,182135
2021,8,24,쇼핑,수입,7993,190128
2020,12,6,여행,수입,4133,194261
2020,6,21,MT,수입,4804,199065
2020,9,10,MT,지출,7624,191441
2023,2,27,식사,수입,6195,197636
2022,7,26,여행,지출,5481,192155
2023,3,28,쇼핑,수입,5094,197249
2021,4,10,쇼핑,지출,9410,187839
2022,12,2,쇼핑,수입,9226,197065
2021,11,9,식사,수입,3516,200581
2022,8,12,여행,지출,2788,197793
2022,5,18,여행,지출,4777,193016
2020,9,20,여행,수입,3379,196395
2023,3,30,체육대회,지출,7653,188742
2023,11,8,체육대회,수입,8468,197210
2023,2,16,MT,지출,2873,194337
2022,9,8,식사,수입,3424,197761
2020,11,21,식사,지출,8573,189188
2022,9,23,여행,지출,5078,184110
2021,8,1,식사,지출,2663,181447
2021,8,28,쇼핑,수입,3012,184459
2023,5,21,체육대회,지출,5717,178742
2023,8,31,MT,지출,7741,171001
2020,10,13,식사,수입,2394,173395
2022,6,23,쇼핑,수입,9302,182697
2023,10,23,쇼핑,수입,9870,192567
2023,4,9,쇼핑,지출,8957,183610
2022,1,27,여행,지출,1215,182395
2020,12,21,여행,수입,5440,187835
2022,3,18,체육대회,수입,4956,192791
2021,2,25,식사,수입,8324,201115
2020,8,2,MT,수입,3356,204471
2020,5,10,여행,수입,7104,211575
2023,10,18,쇼핑,지출,4360,207215
2022,8,19,체육대회,지출,7310,199905
2021,6,15,여행,수입,2066,201971
2021,2,20,체육대회,지출,9588,192383
2022,6,8,체육대회,수입,3779,196162
2021,9,24,여행,수입,3433,199595
2021,11,21,여행,지출,1603,197992
2020,4,7,MT,지출,2269,195723
2020,12,7,MT,수입,8406,204129
2020,2,6,식사,수입,4601,208730
2023,9,19,쇼핑,수입,3256,211986
2020,12,24,MT,지출,6577,205409
2022,6,23,쇼핑,지출,8893,196516
2023,11,16,쇼핑,수입,6605,203121
2023,8,23,식사,수입,7944,211065
2020,6,30,여행,지출,7986,203079
2022,4,27,체육대회,수입,8656,211735
2023,1,22,MT,지출,9645,202090
2022,5,19,MT,지출,2466,199624
2020,11,6,MT,지출,5014,194610
2021,12,10,여행,지출,2918,191692
2021,2,26,여행,수입,6274,197966
2021,5,30,식사,수입,1754,199720
2021,1,21,MT,수입,9503,209223
2020,9,15,MT,지출,3060,206163
2023,9,17,식사,지출,1153,205010
2022,6,18,여행,수입,9087,214097
2023,10,10,식사,지출,1162,212935
2020,11,23,식사,수입,6914,219849
2022,10,3,MT,지출,7164,212685
2022,12,26,식사,수입,1496,214181
2021,5,26,여행,수입,8105,222286
2022,4,30,식사,수입,5020,227306
2020,10,18,식사,지출,7286,220020
2021,5,30,식사,수입,3452,223472
2021,2,23,식사,수입,5300,228772
2023,7,12,체육대회,수입,1292,230064
2023,3,6,MT,수입,2599,232663
2021,12,13,식사,수입,9014,241677
2021,12,28,식사,지출,3355,238322
2023,11,9,식사,지출,7608,230714
2020,5,17,체육대회,지출,1831,228883
2020,8,24,체육대회,수입,4439,233322
2023,3,31,여행,수입,4055,237377
2020,3,13,쇼핑,수입,6217,243594
2022,10,27,여행,지출,4395,239199
2023,2,24,체육대회,지출,7538,231661
2023,2,5,여행,수입,7118,238779
2022,7,6,체육대회,수입,8160,246939
2022,5,30,MT,지출,6614,240325
2020,6,15,여행,수입,2070,242395
2023,10,12,식사,지출,7765,234630
2023,11,30,쇼핑,수입,6798,241428
2023,11,25,여행,수입,9096,250524
2021,1,31,식사,수입,5801,256325
2020,12,5,여행,수입,6888,263213
2023,7,27,쇼핑,지출,9395,253818
2023,4,12,MT,지출,7319,246499
2023,11,5,여행,수입,6668,253167
2021,1,20,체육대회,수입,1825,254992
2023,4,26,여행,지출,6158,248834
2022,10,18,여행,수입,2305,251139
2021,6,15,MT,지출,5614,245525
2022,5,20,체육대회,지출,2363,243162
2023,7,20,체육대회,수입,5445,248607
2021,5,1,MT,지출,1810,246797
2023,12,15,식사,지출,1765,245032
2023,11,5,식사,지출,1024,244008
2022,11,3,식사,지출,8149,235859
2022,12,12,체육대회,지출,1708,234151
2021,10,10,여행,수입,8779,242930
2022,2,3,MT,지출,6185,236745
2022,3,27,여행,지출,1651,235094
2023,12,22,MT,수입,5665,240759
2023,6,5,식사,지출,4224,236535
2022,4,25,쇼핑,지출,2507,234028
2021,5,8,MT,수입,3028,237056
2020,9,9,여행,수입,1033,238089
2022,9,16,체육대회,지출,4108,233981
2022,8,26,MT,지출,3765,230216
2021,6,19,쇼핑,지출,7048,223168
2020,10,7,체육대회,지출,8417,214751
2023,2,22,식사,수입,5049,219800
2023,7,31,쇼핑,수입,1212,221012
2022,12,23,MT,수입,9504,230516
2020,10,28,MT,지출,8237,222279
2022,3,11,쇼핑,지출,5133,217146
2021,6,13,식사,수입,3655,220801
2023,6,9,체육대회,지출,7755,213046
2020,5,22,여행,지출,8097,204949
2022,5,23,쇼핑,수입,6645,211594
2023,2,14,MT,수입,3934,215528
2022,7,13,체육대회,수입,5634,221162
2022,4,22,체육대회,지출,5761,215401
2022,1,13,쇼핑,수입,3929,219330
2023,8,8,쇼핑,지출,4126,215204
2021,5,20,여행,지출,3721,211483
2021,8,10,MT,지출,7631,203852
2020,1,19,MT,지출,8292,195560
2021,10,26,쇼핑,수입,9659,205219
2023,2,19,여행,지출,5973,199246
2023,1,29,여행,지출,5340,193906
2020,12,13,여행,수입,8256,202162
2020,12,16,식사,수입,8061,210223
2023,5,9,여행,지출,1781,208442
2020,12,12,MT,수입,8309,216751
2021,8,9,여행,지출,5734,211017
2021,1,2,체육대회,지출,3798,207219
2020,4,17,식사,수입,1619,208838
2022,10,10,식사,지출,4466,204372
2022,6,26,여행,수입,5547,209919
2022,8,7,쇼핑,지출,8643,201276
2021,5,30,쇼핑,수입,8955,210231
2021,12,16,체육대회,수입,5263,215494
2023,8,6,식사,수입,5508,221002
2022,6,11,쇼핑,수입,5373,226375
2020,5,7,MT,수입,9297,235672
2020,9,1,쇼핑,수입,6141,241813
2020,11,23,여행,지출,8529,233284
2021,11,3,체육대회,지출,6929,226355
2022,7,17,MT,수입,7857,234212
2022,3,1,쇼핑,수입,9003,243215
2023,6,26,체육대회,수입,6452,249667
2022,5,3,여행,수입,1341,251008
2022,5,1,쇼핑,수입,1189,252197
2020,11,27,MT,수입,2766,254963
2022,12,9,여행,수입,8856,263819
2022,12,23,식사,지출,5810,258009
2022,4,14,체육대회,지출,6218,251791
2023,10,2,여행,수입,6995,258786
2022,4,15,여행,지출,8273,250513
2023,3,27,체육대회,수입,9418,259931
2021,6,23,여행,수입,1262,261193
2021,8,26,체육대회,지출,4311,256882
2022,1,17,여행,지출,3396,253486
2021,6,9,MT,지출,9625,243861
2023,10,20,여행,지출,1468,242393
2020,9,13,여행,지출,1802,240591
2020,6,10,쇼핑,수입,8742,249333
2022,9,26,여행,수입,3458,252791
2020,6,12,쇼핑,수입,9506,262297
2021,4,10,체육대회,수입,7256,269553
2022,8,29,식사,수입,8757,278310
2023,4,21,체육대회,지출,5966,272344
2023,11,29,체육대회,수입,7241,279585
2022,11,4,식사,지출,4781,274804
2022,7,13,식사,수입,8567,283371
2021,2,16,쇼핑,지출,3266,280105
2022,6,23,여행,수입,1299,281404
2023,10,21,식사,수입,8728,290132
2022,2,25,체육대회,수입,1516,291648
2023,4,6,여행,지출,8492,283156
2021,7,15,MT,수입,5527,288683
2021,3,6,쇼핑,수입,3046,291729
2023,11,2,체육대회,지출,7654,284075
2020,6,18,쇼핑,수입,5389,289464
2023,1,9,쇼핑,지출,8097,281367
2023,1,26,MT,수입,5920,287287
2023,8,27,MT,수입,4056,291343
2023,2,23,식사,수입,6079,297422
2020,3,27,쇼핑,수입,2130,299552
2020,5,25,여행,수입,1074,300626
2020,2,17,쇼핑,지출,4931,295695
2022,12,20,식사,지출,5886,289809
2022,2,2,체육대회,지출,5489,284320
2020,2,20,체육대회,지출,9071,275249
2022,2,25,MT,수입,8872,284121
2021,3,11,쇼핑,수입,7624,291745
2020,2,17,쇼핑,지출,5925,285820
2021,1,13,쇼핑,지출,4086,281734
2021,8,9,여행,지출,4843,276891
2021,3,9,쇼핑,수입,7410,284301
2022,5,12,여행,수입,4446,288747
2023,3,29,식사,지출,9650,279097
2021,1,7,체육대회,수입,8331,287428
2020,11,6,체육대회,수입,2686,290114
2021,6,22,식사,지출,4572,285542
2023,5,6,MT,수입,3793,289335
2020,12,23,체육대회,수입,7846,297181
2023,7,7,MT,수입,8518,305699
2021,2,1,체육대회,수입,3382,309081
2022,5,24,식사,지출,4366,304715
2020,7,1,쇼핑,지출,9703,295012
2020,4,25,쇼핑,수입,5809,300821
2023,7,13,식사,수입,5701,306522
2020,7,17,체육대회,수입,6079,312601
2023,8,12,여행,수입,8699,321300
2020,10,30,MT,수입,3927,325227
2021,2,27,여행,수입,1845,327072
2022,10,23,식사,지출,8744,318328
2022,10,15,쇼핑,수입,1398,319726
2021,6,14,여행,수입,8999,328725
2022,4,1,식사,지출,6281,322444
2021,6,5,식사,수입,1722,324166
2023,8,18,여행,지출,8813,315353
2020,12,22,쇼핑,지출,5324,310029
2023,11,21,체육대회,지출,8022,302007
2023,11,22,쇼핑,지출,6212,295795
2020,5,8,식사,지출,6427,289368
2021,5,25,체육대회,지출,3507,285861
2020,7,14,식사,수입,2532,288393
2020,4,21,MT,지출,4724,283669
2023,1,30,MT,수입,7257,290926
2020,3,26,쇼핑,지출,2430,288496
2023,12,6,식사,지출,3440,285056
2022,2,20,MT,수입,2367,287423
2021,9,7,쇼핑,수입,3744,291167
2021,4,1,MT,지출,3245,287922
2021,8,5,MT,지출,3443,284479
2021,6,8,MT,지출,8072,276407
2020,4,30,식사,지출,3915,272492
2021,5,8,여행,수입,1476,273968
2022,8,13,체육대회,지출,6178,267790
2023,9,17,MT,지출,2776,265014
2021,9,10,MT,지출,9285,255729
2021,9,2,식사,지출,6805,248924
2021,6,11,쇼핑,수입,2222,251146
2022,7,2,식사,수입,6043,257189
2023,1,27,식사,수입,6481,263670
2023,2,1,쇼핑,지출,9804,253866
2020,1,17,여행,지출,2892,250974
2022,9,27,체육대회,지출,6160,244814
2022,5,26,체육대회,지출,1390,243424
2023,10,21,쇼핑,수입,8708,252132
2022,10,12,쇼핑,지출,1290,250842
2022,10,19,MT,수입,1303,252145
2020,10,4,MT,수입,7245,259390
2022,11,19,쇼핑,지출,9446,249944
2022,9,24,식사,지출,6659,243285
2023,4,8,여행,수입,1640,244925
2020,6,20,식사,수입,6530,251455
2020,12,8,MT,지출,9195,242260
2023,10,3,쇼핑,지출,2754,239506
2020,1,23,여행,지출,3512,235994
2023,7,12,MT,수입,5163,241157
2020,6,2,MT,수입,4740,245897
2020,1,15,여행,지출,2378,243519
2021,5,12,여행,수입,7257,250776
2021,8,23,MT,지출,7979,242797
2023,11,27,여행,수입,3831,246628
2023,8,9,MT,수입,7713,254341
2020,2,27,쇼핑,지출,4155,250186
2020,1,8,여행,지출,6716,243470
2020,2,20,MT,지출,3750,239720
2021,4,29,쇼핑,지출,7210,232510
2020,3,11,체육대회,수입,6328,238838
2021,8,5,체육대회,지출,4684,234154
2020,8,25,쇼핑,수입,1979,236133
2022,3,10,쇼핑,지출,3663,232470
2022,12,23,MT,지출,7047,225423
2020,2,8,식사,수입,5209,230632
2021,11,30,식사,지출,5709,224923
2021,1,14,여행,지출,5899,219024
2020,6,6,MT,지출,2251,216773
2021,6,29,MT,지출,3478,213295
2021,9,24,체육대회,수입,6609,219904
2022,4,28,식사,지출,4109,215795
2023,11,10,쇼핑,지출,4028,211767
2020,2,19,여행,지출,4811,206956
2022,8,26,MT,수입,3681,210637
2022,5,16,MT,지출,8436,202201
2020,8,29,MT,지출,2824,199377
2020,12,19,체육대회,지출,8553,190824
2020,6,21,체육대회,지출,3704,187120
2021,2,3,쇼핑,수입,2530,189650
2021,2,15,MT,지출,4253,185397
2023,4,30,여행,수입,2045,187442
2020,4,13,체육대회,지출,2081,185361
2023,12,19,MT,지출,2513,182848
2023,11,28,체육대회,지출,7483,175365
2021,1,25,쇼핑,지출,9450,165915
2020,2,29,MT,지출,5265,160650
2022,5,31,쇼핑,수입,6344,166994
2020,6,4,여행,지출,5087,161907
2023,6,27,MT,수입,8037,169944
2020,5,4,여행,지출,2865,167079
2020,12,23,체육대회,수입,1170,168249
2021,2,13,여행,지출,4956,163293
2023,6,2,쇼핑,지출,1496,161797
2022,8,27,여행,수입,4668,166465
2022,12,15,체육대회,수입,6137,172602
2021,7,28,체육대회,지출,3555,169047
2020,2,29,체육대회,지출,7271,161776
2022,8,19,식사,지출,8124,153652
2021,5,8,MT,지출,8391,145261
2022,7,29,식사,지출,7646,137615
2022,5,23,쇼핑,수입,7185,144800
2021,1,7,여행,수입,7889,152689
2023,9,2,식사,지출,6519,146170
2021,6,29,MT,지출,6645,139525
2023,1,9,MT,수입,6533,146058
2021,9,1,체육대회,지출,6295,139763
2020,7,6,쇼핑,지출,6369,133394
2023,1,28,MT,지출,3431,129963
2022,2,28,여행,지출,4992,124971
2021,8,20,MT,수입,4050,129021
2022,5,13,체육대회,수입,3844,132865
2022,5,17,MT,수입,1167,134032
2021,12,24,쇼핑,수입,3909,137941
2023,5,14,식사,수입,9138,147079
2023,7,24,쇼핑,지출,3008,144071
2021,7,4,쇼핑,수입,4463,148534
2022,4,24,쇼핑,수입,4224,152758
2020,5,9,체육대회,지출,8897,143861
2022,6,18,쇼핑,지출,7883,135978
2021,12,6,체육대회,수입,2059,138037
2023,9,27,식사,수입,3575,141612
2020,1,2,MT,지출,5245,136367
2021,11,16,쇼핑,지출,8572,127795
2020,2,16,식사,지출,4568,123227
2020,4,10,여행,수입,8088,131315
2022,6,19,쇼핑,지출,8519,122796
2021,8,9,MT,수입,5179,127975
2022,11,30,쇼핑,수입,4958,132933
2022,1,26,쇼핑,지출,5067,127866
2022,9,21,체육대회,수입,8245,136111
2020,7,20,MT,지출,8630,127481
2021,3,23,체육대회,수입,4141,131622
2022,9,29,식사,수입,4980,136602
2023,10,25,여행,수입,6898,143500
2021,5,23,여행,지출,1319,142181
2021,7,10,식사,지출,5129,137052
2023,2,9,여행,수입,3362,140414
2020,10,12,식사,지출,6029,134385
2022,4,28,쇼핑,수입,1349,135734
2020,6,3,식사,수입,2926,138660
2021,1,23,쇼핑,지출,4105,134555
2023,2,12,MT,수입,6371,140926
2022,2,8,여행,수입,9715,150641
2020,2,13,식사,수입,6656,157297
2021,6,9,여행,수입,1451,158748
2023,1,2,쇼핑,지출,3125,155623
2021,6,10,MT,지출,7462,148161
2023,3,9,식사,지출,4732,143429
2022,9,4,쇼핑,수입,9002,152431
2023,8,12,여행,수입,7590,160021
2022,3,24,체육대회,지출,4571,155450
2022,12,22,체육대회,지출,1429,154021
2023,2,13,여행,수입,1980,156001
2022,4,18,쇼핑,수입,1980,157981
2021,3,9,식사,수입,9811,167792
2023,5,12,MT,지출,9001,158791
2023,7,17,쇼핑,지출,8068,150723
2023,2,8,쇼핑,지출,7728,142995
2020,4,23,체육대회,수입,2691,145686
2023,4,22,MT,수입,6220,151906
2020,6,18,쇼핑,지출,7904,144002
2022,8,30,체육대회,수입,1429,145431
2020,6,25,쇼핑,지출,6395,139036
2020,1,17,식사,수입,7241,146277
2020,5,1,쇼핑,지출,5562,140715
2020,6,28,MT,수입,9872,150587
2023,5,22,쇼핑,지출,2163,148424
2023,1,21,여행,수입,2892,151316
2022,1,28,체육대회,지출,7123,144193
2022,2,11,MT,수입,8704,152897
2022,1,1,MT,지출,4990,147907
2021,6,6,MT,지출,8601,139306
2023,11,15,쇼핑,수입,4165,143471
2023,4,25,체육대회,수입,8828,152299
2022,10,2,MT,지출,9856,142443
2023,6,26,체육대회,수입,1392,143835
2023,8,28,MT,지출,5905,137930
2023,10,19,쇼핑,수입,9148,147078
2022,6,1,쇼핑,지출,7416,139662
2021,10,17,체육대회,지출,1145,138517
2021,12,8,여행,지출,1867,136650
2021,6,8,체육대회,수입,6869,143519
2020,7,11,체육대회,수입,4501,148020
2020,7,21,체육대회,지출,8338,139682
2023,2,11,쇼핑,지출,8574,131108
2022,10,12,체육대회,수입,7596,138704
2020,6,8,체육대회,수입,6801,145505
2020,6,27,MT,수입,6614,152119
2022,1,28,MT,수입,8011,160130
2020,6,15,체육대회,수입,3785,163915
2020,4,9,여행,지출,3840,160075
2022,7,25,여행,지출,7512,152563
2020,2,10,체육대회,수입,7731,160294
2023,5,8,체육대회,지출,6005,154289
2022,9,9,식사,지출,9480,144809
2021,7,8,MT,지출,3671,141138
2020,10,10,쇼핑,지출,3997,137141
2020,11,26,MT,수입,4116,141257
2022,2,20,여행,수입,5920,147177
2020,7,30,여행,수입,1328,148505
2023,3,5,MT,지출,9041,139464
2020,10,13,MT,수입,4359,143823
2022,10,18,쇼핑,지출,5151,138672
2020,12,4,MT,수입,5993,144665
2022,3,27,MT,지출,1828,142837
2022,12,8,식사,수입,1036,143873
2021,7,23,여행,지출,2090,141783
2023,9,2,MT,지출,4860,136923
2021,8,28,쇼핑,수입,8696,145619
2020,1,25,여행,수입,1418,147037
2021,11,21,체육대회,수입,4363,151400
2021,1,9,쇼핑,지출,4447,146953
2020,2,18,여행,수입,2235,149188
2023,6,20,MT,수입,7843,157031
2022,2,28,MT,수입,7504,164535
2020,1,22,체육대회,지출,6120,158415
2021,7,14,쇼핑,지출,1988,156427
2020,1,9,식사,지출,7979,148448
2023,5,4,체육대회,지출,9796,138652
2021,12,18,식사,수입,4013,142665
2021,1,29,쇼핑,수입,1957,144622
2023,6,3,체육대회,지출,3534,141088
2022,7,3,여행,수입,5856,146944
2023,4,22,식사,지출,6279,140665
2022,10,11,여행,지출,1641,139024
2021,5,28,MT,지출,3362,135662
2021,6,17,쇼핑,수입,6411,142073
2022,6,23,여행,수입,9588,151661
2022,11,21,식사,수입,4125,155786
2020,1,2,쇼핑,지출,5156,150630
2020,2,19,여행,수입,9356,159986
2021,12,13,MT,수입,4989,164975
2023,7,31,식사,수입,1980,166955
2021,7,10,MT,지출,1344,165611
2022,8,29,쇼핑,수입,1664,167275
2022,11,22,식사,수입,5730,173005
2021,5,18,쇼핑,지출,8228,164777
2020,10,4,MT,수입,1134,165911
2023,12,16,체육대회,수입,9744,175655
2021,9,30,여행,수입,4701,180356
2021,2,9,여행,지출,9931,170425
2023,6,3,체육대회,수입,6257,176682
2021,10,13,식사,수입,7270,183952
2022,6,27,쇼핑,지출,2322,181630
2023,10,3,MT,지출,5664,175966
2020,10,31,쇼핑,지출,9767,166199
2020,7,29,여행,수입,4956,171155
2020,12,7,여행,지출,2176,168979
2020,4,25,쇼핑,수입,8544,177523
2021,11,6,식사,지출,1796,175727
2023,4,5,쇼핑,수입,8247,183974
2020,1,8,여행,수입,7531,191505
2022,1,4,쇼핑,지출,7186,184319
2021,7,4,쇼핑,수입,5704,190023
2022,11,17,식사,수입,9687,199710
2021,1,16,쇼핑,수입,6807,206517
2022,4,30,체육대회,지출,3455,203062
2021,1,17,여행,지출,5672,197390
2023,6,2,체육대회,수입,6636,204026
2023,2,19,체육대회,지출,7665,196361
2020,10,16,체육대회,수입,1833,198194
2023,9,17,여행,지출,8299,189895
2022,11,7,MT,지출,7135,182760
2023,11,25,여행,지출,8979,173781
2021,8,22,쇼핑,수입,6433,180214
2022,11,7,여행,지출,3490,176724
2023,2,18,체육대회,지출,7373,169351
2021,4,29,식사,지출,1401,167950
2020,1,25,식사,지출,7044,160906
2020,8,5,여행,지출,3865,157041
2022,8,18,식사,지출,7153,149888
2022,11,24,쇼핑,지출,6499,143389
2021,3,27,식사,수입,1719,145108
2022,12,7,식사,수입,3880,148988
2023,7,15,체육대회,지출,9214,139774
2020,10,4,체육대회,지출,1809,137965
2023,4,29,식사,수입,8458,146423
2022,4,11,MT,수입,8968,155391
2022,8,24,쇼핑,수입,9789,165180
2021,10,16,식사,수입,7896,173076
2020,12,12,MT,수입,9798,182874
2023,6,19,MT,지출,6672,176202
2022,1,18,식사,지출,8053,168149
2020,9,14,MT,지출,6208,161941
2023,11,24,여행,수입,8527,170468
2021,5,19,체육대회,지출,3349,167119
2020,2,2,쇼핑,지출,6496,160623
2021,1,8,MT,수입,1277,161900
2023,11,22,식사,지출,3411,158489
2022,7,31,식사,지출,1413,157076
2020,5,24,식사,수입,4593,161669
2022,11,17,식사,지출,3406,158263
2021,12,29,MT,지출,9966,148297
2023,2,5,쇼핑,지출,4831,143466
2020,7,9,식사,지출,2280,141186
2022,12,8,쇼핑,수입,3690,144876
2023,8,5,여행,수입,4621,149497
2021,11,3,쇼핑,수입,1427,150924
2020,9,18,MT,수입,3469,154393
2023,3,21,쇼핑,수입,4926,159319
2023,11,13,여행,지출,4650,154669
2021,8,12,체육대회,지출,7306,147363
2022,11,11,식사,지출,8677,138686
2022,5,7,체육대회,수입,2144,140830
2021,2,10,쇼핑,수입,7081,147911
2022,10,13,식사,수입,2728,150639
2021,6,21,MT,수입,2065,152704
2023,5,13,MT,수입,3639,156343
2022,11,8,쇼핑,지출,1624,154719
2023,6,30,MT,지출,8641,146078
2022,11,11,쇼핑,수입,6294,152372
2021,7,31,MT,수입,4208,156580
2020,12,12,MT,지출,8117,148463
2021,7,2,체육대회,수입,3699,152162
2023,1,9,여행,지출,9620,142542
2022,11,6,쇼핑,지출,3334,139208
2021,9,2,쇼핑,수입,1189,140397
2022,9,4,체육대회,지출,7645,132752
2021,10,3,MT,수입,6042,138794
2021,11,11,체육대회,지출,5285,133509
2020,2,27,식사,수입,2745,136254
2023,8,4,체육대회,수입,7563,143817
2021,2,18,식사,지출,2968,140849
2021,5,9,체육대회,수입,1694,142543
2022,2,7,체육대회,지출,6763,135780
2021,7,30,쇼핑,수입,8303,144083
2023,2,26,여행,지출,6509,137574
2021,9,9,쇼핑,지출,9409,128165
2021,8,18,식사,지출,5864,122301
2021,1,21,여행,수입,9062,131363
2021,4,4,여행,지출,9963,121400
2020,5,21,식사,지출,4883,116517
2022,4,23,체육대회,수입,7702,124219
2020,1,24,체육대회,수입,6788,131007
2023,7,21,여행,수입,9057,140064
2021,6,5,여행,수입,8429,148493
2020,11,26,체육대회,지출,1096,147397
2022,5,17,여행,지출,1473,145924
2022,1,15,MT,수입,2695,148619
2020,12,5,체육대회,지출,8302,140317
2020,4,25,여행,지출,6471,133846
2023,12,1,MT,수입,1935,135781
2022,4,13,쇼핑,지출,4561,131220
2021,2,6,여행,지출,5052,126168
2022,7,12,체육대회,수입,4845,131013
2020,7,14,식사,지출,8385,122628
2020,12,10,여행,지출,7187,115441
2021,11,8,여행,수입,9930,125371
2020,7,7,MT,지출,4927,120444
2023,6,18,체육대회,지출,6805,113639
2021,7,26,식사,수입,7938,121577
2020,6,29,여행,지출,3944,117633
2022,3,1,여행,지출,2362,115271
2022,9,6,체육대회,지출,4337,110934
2021,8,6,쇼핑,수입,4180,115114
2023,11,27,체육대회,수입,3542,118656
2020,11,7,MT,지출,2881,115775
2022,4,13,체육대회,수입,6171,121946
2021,5,10,여행,수입,8318,130264
2022,3,4,쇼핑,지출,2667,127597
2023,1,22,체육대회,수입,3074,130671
2023,8,6,체육대회,지출,1412,129259
2020,3,17,쇼핑,지출,1388,127871
2020,1,9,여행,수입,5443,133314
2022,2,13,여행,수입,1301,134615
2023,10,30,쇼핑,지출,7129,127486
2021,1,5,체육대회,수입,2413,129899
2023,4,27,MT,수입,4672,134571
2022,6,24,체육대회,수입,3557,138128
2022,11,21,식사,수입,9244,147372
2021,4,8,MT,지출,1964,145408
2023,6,2,쇼핑,수입,1292,146700
2023,4,9,여행,수입,3989,150689
2022,9,11,쇼핑,수입,1588,152277
2020,10,15,식사,지출,5719,146558
2021,9,13,여행,수입,7489,154047
2021,10,18,쇼핑,지출,4065,149982
2022,3,20,식사,수입,6936,156918
2022,7,17,쇼핑,지출,7525,149393
2021,1,6,쇼핑,수입,5740,155133
2023,5,6,여행,수입,1514,156647
2022,4,9,쇼핑,수입,7081,163728
2022,9,16,쇼핑,지출,5317,158411
2021,12,22,여행,지출,8758,149653
2020,4,3,쇼핑,지출,8430,141223
2020,9,11,식사,지출,6563,134660
2023,3,13,체육대회,수입,7495,142155
2023,8,15,식사,지출,3392,138763
2022,4,7,MT,지출,3807,134956
2022,4,10,쇼핑,수입,8531,143487
2021,6,18,식사,수입,6212,149699
2020,3,12,쇼핑,수입,2983,152682
2022,7,27,MT,수입,5722,158404
2021,2,24,여행,지출,6363,152041
2020,12,6,식사,지출,3533,148508
2020,9,21,쇼핑,수입,4048,152556
2023,2,25,MT,지출,6476,146080
2020,2,13,식사,수입,2135,148215
2023,11,21,쇼핑,지출,1604,146611
2023,7,26,식사,수입,2191,148802
2023,4,7,식사,수입,4102,152904
2020,2,28,쇼핑,지출,9965,142939
2021,12,27,MT,수입,3354,146293
2020,6,9,MT,수입,9486,155779
2021,6,30,체육대회,수입,5001,160780
2020,12,30,MT,수입,7804,168584
2020,2,29,식사,수입,3486,172070
2022,11,18,MT,수입,4522,176592
2023,6,27,MT,수입,3462,180054
2022,12,14,체육대회,수입,4076,184130
2023,12,27,체육대회,수입,4322,188452
2021,1,24,체육대회,수입,3299,191751
2020,9,11,쇼핑,수입,6609,198360
2021,5,5,쇼핑,수입,7577,205937
2023,9,29,체육대회,수입,6422,212359
2023,12,5,여행,수입,3212,215571
2020,9,30,쇼핑,지출,4408,211163
2021,10,19,여행,수입,7257,218420
2022,10,11,MT,수입,9200,227620
2020,6,29,식사,지출,5107,222513
2020,5,20,여행,지출,6914,215599
2021,12,4,쇼핑,수입,7100,222699
2020,9,28,체육대회,지출,3659,219040
2022,1,25,MT,수입,9158,228198
2023,8,5,여행,수입,2111,230309
2020,9,4,MT,수입,8896,239205
2020,10,26,여행,수입,5884,245089
2022,6,27,MT,지출,6276,238813
2022,1,24,체육대회,수입,5563,244376
2022,8,4,MT,수입,5573,249949
2020,1,2,쇼핑,지출,1011,248938
2022,3,17,여행,지출,5175,243763
2023,5,20,MT,지출,7659,236104
2020,1,1,MT,지출,2683,233421
2021,6,5,MT,지출,2739,230682
2021,2,11,MT,지출,4384,226298
2023,7,2,식사,지출,9766,216532
2020,4,7,여행,수입,6997,223529
2021,11,19,식사,수입,8959,232488
2020,1,31,쇼핑,지출,6385,226103
2021,2,16,식사,수입,2324,228427
2020,1,1,여행,지출,6967,221460
2020,10,19,여행,지출,4228,217232
2021,5,3,MT,지출,1960,215272
2022,12,4,MT,지출,6411,208861
2022,7,25,쇼핑,지출,7278,201583
2021,5,3,여행,지출,5505,196078
2021,8,28,MT,수입,9574,205652
2021,8,30,여행,지출,6736,198916
2020,12,11,쇼핑,수입,8000,206916
2021,12,23,식사,지출,5134,201782
2022,5,10,체육대회,지출,7577,194205
2020,9,25,MT,수입,3623,197828
2020,3,1,체육대회,수입,5218,203046
2020,11,13,체육대회,지출,6464,196582
2021,1,12,쇼핑,수입,1551,198133
2022,1,4,여행,수입,7669,205802
2020,1,22,여행,수입,4584,210386
2021,1,8,여행,수입,4349,214735
2020,10,17,쇼핑,지출,2238,212497
2023,1,24,체육대회,수입,2917,215414
2023,1,7,체육대회,수입,3401,218815
2023,5,29,MT,수입,5797,224612
2020,1,8,체육대회,수입,5826,230438
2023,3,31,식사,지출,5219,225219
2021,8,13,체육대회,지출,5279,219940
2022,6,5,여행,지출,1394,218546
2020,6,14,MT,수입,5048,223594
2023,11,6,여행,수입,8537,232131
2023,3,31,여행,지출,9361,222770
2023,7,18,체육대회,수입,2730,225500
2020,6,30,식사,수입,2723,228223
2020,10,12,체육대회,지출,4595,223628
2021,12,20,쇼핑,지출,8443,215185
2021,8,29,식사,지출,9089,206096
2021,7,21,체육대회,수입,1040,207136
2021,9,18,식사,지출,9593,197543
2023,9,28,체육대회,지출,1212,196331
2020,10,27,체육대회,지출,7374,188957
2022,8,10,식사,수입,3123,192080
2022,12,16,식사,지출,9966,182114
2023,6,18,여행,지출,7144,174970
2021,4,19,체육대회,수입,1338,176308
2021,1,21,쇼핑,지출,6544,169764
2023,2,28,여행,지출,4043,165721
2023,12,2,식사,지출,7417,158304
2023,12,3,체육대회,지출,8811,149493
2020,1,21,체육대회,수입,6875,156368
2022,5,23,체육대회,수입,5405,161773
2022,10,4,쇼핑,수입,8672,170445
2022,4,5,식사,수입,3818,174263
2020,4,20,체육대회,수입,7335,181598
2022,4,17,쇼핑,지출,9671,171927
2022,7,18,체육대회,수입,9899,181826
2021,11,10,체육대회,지출,5388,176438
2020,1,16,식사,수입,9200,185638
2020,7,30,여행,지출,9006,176632
2021,10,26,여행,지출,4305,172327
2021,3,26,체육대회,지출,6735,165592
2021,2,12,MT,지출,7815,157777
2023,12,8,여행,수입,8461,166238
2020,3,13,MT,지출,4607,161631
2020,12,29,쇼핑,수입,2914,164545
2020,7,21,MT,수입,4975,169520
2022,2,7,MT,지출,4657,164863
2023,4,28,쇼핑,수입,4249,169112
2021,6,24,여행,수입,5206,174318
2021,8,25,MT,수입,4936,179254
2020,7,19,체육대회,수입,5011,184265
2022,9,4,체육대회,지출,2330,181935
2021,11,23,쇼핑,지출,1442,180493
2021,4,19,여행,수입,1117,181610
2021,5,3,쇼핑,지출,3752,177858
2021,7,25,쇼핑,지출,2151,175707
2020,4,19,MT,지출,6804,168903
2022,10,22,식사,지출,1550,167353
2021,3,3,체육대회,수입,5195,172548
2020,7,13,MT,지출,6828,165720
2022,9,29,MT,지출,1985,163735
2021,5,2,식사,지출,8134,155601
2023,9,16,여행,지출,1439,154162
2020,11,2,여행,수입,6352,160514
2022,7,30,식사,지출,7062,153452
2020,11,19,쇼핑,수입,7251,160703
2023,9,22,체육대회,수입,1159,161862
2023,4,18,MT,수입,6124,167986
2020,10,2,여행,수입,9295,177281
2022,11,9,여행,지출,5327,171954
2021,8,17,식사,지출,8913,163041
2020,6,27,여행,지출,8767,154274
2021,11,18,여행,지출,4451,149823
2020,4,21,식사,지출,6533,143290
2020,5,3,쇼핑,수입,9192,152482
2020,6,26,식사,수입,4990,157472
2020,1,17,MT,수입,9402,166874
2022,4,29,식사,수입,2883,169757
2023,2,20,체육대회,지출,2747,167010
2020,9,17,체육대회,수입,1791,168801
2022,7,15,쇼핑,수입,7536,176337
2022,12,15,체육대회,지출,3410,172927
2020,10,16,체육대회,수입,1351,174278
2021,10,9,쇼핑,지출,4060,170218
2020,2,24,쇼핑,지출,6325,163893
2021,4,21,여행,수입,6706,170599
2021,4,15,체육대회,지출,8140,162459
2022,7,29,체육대회,수입,3772,166231
2022,1,10,여행,지출,8342,157889
2022,9,13,MT,수입,3382,161271
2023,11,6,MT,수입,2166,163437
2022,5,7,식사,수입,2628,166065
2021,5,28,쇼핑,수입,2576,168641
2023,11,17,체육대회,수입,7896,176537
2023,10,24,여행,수입,4123,180660
2020,9,19,MT,지출,1306,179354
2022,8,27,MT,수입,4162,183516
2023,9,14,MT,수입,1458,184974
2020,6,15,MT,지출,8857,176117
2022,7,25,식사,수입,3620,179737
2021,5,31,여행,지출,1594,178143
2022,11,1,식사,지출,1992,176151
2020,8,3,여행,지출,5760,170391
2023,8,27,체육대회,지출,6841,163550
2023,8,10,식사,지출,8535,155015
2021,6,10,체육대회,수입,9820,164835
2021,3,8,쇼핑,지출,7786,157049
2023,6,4,식사,수입,2072,159121
2020,9,28,여행,지출,2261,156860
2021,3,3,쇼핑,지출,3864,152996
2021,9,13,여행,지출,7615,145381
2023,8,17,여행,지출,2329,143052
2023,10,18,체육대회,수입,4451,147503
2022,2,23,식사,지출,4476,143027
2021,3,21,MT,수입,8790,151817
2020,1,6,여행,수입,1036,152853
2022,12,19,식사,수입,2940,155793
2023,9,8,MT,지출,9698,146095
2023,7,3,여행,수입,7960,154055
2020,7,13,쇼핑,수입,2409,156464
2020,10,14,쇼핑,수입,7734,164198
2020,3,3,식사,지출,7093,157105
2023,8,4,체육대회,수입,2681,159786
2020,10,9,식사,수입,3086,162872
2021,1,14,식사,수입,2275,165147
2022,6,13,여행,지출,9654,155493
2021,12,19,쇼핑,지출,7058,148435
2023,2,17,여행,지출,5124,143311
2020,6,10,식사,지출,9191,134120
2021,10,28,체육대회,지출,7237,126883
2020,8,29,MT,수입,6126,133009
2023,3,23,여행,지출,1454,131555
2022,5,10,여행,지출,1039,130516
2023,10,11,MT,지출,4617,125899
2023,9,4,체육대회,수입,8364,134263
2021,3,25,식사,지출,9876,124387
2022,4,24,MT,지출,7937,116450
2023,5,24,여행,수입,5731,122181
2021,8,17,쇼핑,수입,9841,132022
2020,4,13,MT,지출,4582,127440
2021,10,2,MT,수입,6703,134143
2020,5,26,MT,수입,3781,137924
2021,11,8,식사,수입,6037,143961
2022,4,17,체육대회,수입,8113,152074
2023,3,6,MT,지출,1563,150511
2020,8,28,식사,수입,2689,153200
2021,8,15,쇼핑,지출,2514,150686
2020,12,31,여행,지출,8836,141850
2022,6,16,여행,수입,3848,145698
2023,10,14,MT,수입,4287,149985
2021,11,16,쇼핑,수입,4000,153985
2023,5,13,여행,지출,6468,147517
2023,2,10,MT,수입,4877,152394
2020,4,8,여행,수입,6010,158404
2022,12,12,쇼핑,수입,6186,164590
2021,2,4,식사,지출,9317,155273
2021,6,8,체육대회,지출,6965,148308
2023,10,25,쇼핑,지출,6700,141608
2023,2,11,여행,지출,3808,137800
2022,5,1,MT,지출,3834,133966
2022,4,5,MT,수입,9017,142983
2021,9,8,체육대회,수입,7620,150603
2020,7,12,식사,수입,5832,156435
2023,12,22,쇼핑,지출,1536,154899
2023,7,12,쇼핑,지출,8612,146287
2021,2,8,여행,수입,7627,153914
2023,5,13,체육대회,지출,8259,145655
2021,2,16,MT,지출,2610,143045
2023,4,30,MT,지출,7876,135169
2022,2,14,쇼핑,지출,6170,128999
2021,7,16,여행,지출,2538,126461
2020,11,23,식사,지출,2427,124034
2021,9,4,MT,수입,3639,127673
2020,11,26,MT,수입,1513,129186
2020,6,26,MT,수입,2862,132048
2021,9,21,쇼핑,지출,3493,128555
2021,7,3,여행,수입,4233,132788
2023,1,21,여행,수입,4331,137119
2020,7,23,쇼핑,지출,9785,127334
2023,11,1,체육대회,지출,6492,120842
2023,6,14,MT,지출,1243,119599
2021,4,30,여행,지출,1877,117722
2023,10,7,쇼핑,수입,2455,120177
2021,3,27,체육대회,수입,8607,128784
2022,11,1,여행,지출,4796,123988
2020,9,18,MT,수입,3459,127447
2021,1,8,MT,수입,7035,134482
2023,4,18,식사,지출,7379,127103
2023,12,31,쇼핑,수입,3922,131025
2022,7,25,여행,지출,6104,124921
2023,6,12,쇼핑,수입,4033,128954
2020,3,7,체육대회,수입,1464,130418
2022,12,13,식사,수입,3578,133996
2021,11,1,식사,수입,4789,138785
2021,9,6,식사,지출,5379,133406
2023,4,22,MT,수입,5779,139185
2020,11,28,식사,지출,8707,130478
2021,4,11,식사,수입,7533,138011
2023,5,22,체육대회,수입,3900,141911
2020,11,4,체육대회,지출,5169,136742
2020,12,26,MT,지출,1366,135376
2021,2,15,쇼핑,지출,3881,131495
2022,3,4,식사,수입,6136,137631
2020,6,14,체육대회,지출,2048,135583
2023,1,14,MT,수입,1115,136698
2021,10,31,MT,수입,6280,142978
2022,9,30,식사,지출,8010,134968
2020,5,3,쇼핑,수입,6418,141386
2023,6,27,식사,수입,4716,146102
2023,3,30,식사,지출,7508,138594
2022,9,29,쇼핑,지출,6293,132301
2023,1,17,식사,지출,8329,123972
2021,11,2,여행,수입,7797,131769
2023,1,24,체육대회,지출,1148,130621
2021,9,5,체육대회,지출,6505,124116
2022,5,30,쇼핑,지출,5420,118696
2023,10,17,MT,지출,5116,113580
2021,3,6,MT,지출,4366,109214
2021,5,30,쇼핑,수입,8171,117385
2022,10,26,식사,지출,9553,107832
2021,1,8,여행,지출,9796,98036
2020,9,8,쇼핑,수입,7480,105516
2022,6,15,MT,수입,8265,113781
2023,1,12,MT,수입,9479,123260
2020,3,16,체육대회,지출,1007,122253
2023,10,24,식사,지출,1096,121157
2021,1,14,체육대회,수입,8370,129527
2023,4,5,여행,수입,7275,136802
2021,2,6,체육대회,수입,4345,141147
2023,2,1,쇼핑,수입,3436,144583
2023,8,11,쇼핑,수입,7615,152198
2020,4,28,여행,지출,1904,150294
2020,3,16,MT,지출,6624,143670
2021,3,25,MT,수입,5356,149026
2020,7,12,여행,수입,1303,150329
2021,8,1,MT,지출,7203,143126
2020,10,1,MT,수입,9535,152661
2023,4,7,쇼핑,수입,2003,154664
2021,11,30,식사,수입,2280,156944
2023,12,15,여행,지출,5154,151790
2020,3,3,MT,지출,6203,145587
2020,8,9,식사,수입,8364,153951
2022,6,21,식사,수입,9265,163216
2022,6,23,MT,지출,4951,158265
2022,2,17,여행,수입,1848,160113
2023,1,14,식사,수입,3811,163924
2023,8,27,쇼핑,지출,1280,162644
2023,2,20,식사,수입,5426,168070
2022,3,28,체육대회,지출,7593,160477
2022,1,12,체육대회,지출,8429,152048
2022,2,10,MT,수입,6596,158644
2020,6,20,식사,수입,8908,167552
2020,4,21,쇼핑,수입,7105,174657
2023,3,26,MT,수입,7874,182531
2020,3,31,쇼핑,지출,8515,174016
2022,4,12,쇼핑,지출,5588,168428
2022,2,2,MT,수입,7544,175972
2020,2,2,식사,수입,5290,181262
2022,12,14,체육대회,지출,3957,177305
2023,7,17,체육대회,수입,5566,182871
2023,5,21,쇼핑,지출,8579,174292
2021,4,3,식사,지출,5105,169187
2020,9,25,MT,지출,5424,163763
2020,4,17,체육대회,지출,2115,161648
2023,1,31,MT,수입,9054,170702
2023,1,24,체육대회,수입,9535,180237
2021,5,25,체육대회,수입,1046,181283
2022,1,6,여행,지출,4352,176931
2022,12,8,여행,수입,4826,181757
2020,9,30,쇼핑,수입,2898,184655
2020,7,2,쇼핑,수입,6256,190911
2020,7,10,여행,지출,1030,189881
2021,8,4,쇼핑,수입,2752,192633
2022,8,19,체육대회,수입,8012,200645
2022,1,4,MT,지출,1052,199593
2021,9,17,여행,지출,3409,196184
2021,10,10,여행,수입,2927,199111
2020,6,14,쇼핑,지출,9864,189247
2021,5,20,체육대회,수입,9152,198399
2022,2,26,체육대회,수입,3400,201799
2023,8,10,MT,수입,8985,210784
2020,6,14,쇼핑,지출,3643,207141
2022,4,22,체육대회,지출,1324,205817
2020,3,28,식사,수입,5060,210877
2021,5,8,쇼핑,수입,5366,216243
2023,2,16,체육대회,수입,9791,226034
2021,6,12,여행,수입,2369,228403
2023,4,14,식사,수입,2338,230741
2023,6,13,여행,지출,8827,221914
2021,6,16,식사,수입,6504,228418
2020,8,3,MT,수입,4625,233043
2023,11,27,체육대회,수입,7803,240846
2020,2,29,여행,지출,7909,232937
2021,3,3,MT,지출,5786,227151
2021,7,22,체육대회,지출,7101,220050
2021,4,27,여행,수입,6536,226586
2020,12,15,여행,지출,5852,220734
2020,4,14,여행,지출,6407,214327
2023,2,15,여행,수입,2660,216987
2021,4,15,MT,수입,9771,226758
2020,10,26,쇼핑,지출,7376,219382
2022,1,6,식사,수입,7865,227247
2023,5,20,MT,수입,1759,229006
2023,11,5,MT,수입,1280,230286
2023,5,11,MT,지출,1128,229158
2023,1,8,MT,지출,3128,226030
2020,12,17,식사,지출,1628,224402
2021,7,19,쇼핑,수입,6439,230841
2020,1,2,MT,수입,2834,233675
2023,4,5,쇼핑,지출,6120,227555
2022,12,18,여행,지출,1661,225894
2023,8,29,식사,수입,3558,229452
2023,8,6,여행,수입,3547,232999
2023,11,25,체육대회,수입,6114,239113
2023,6,19,쇼핑,지출,2090,237023
2022,9,16,쇼핑,수입,2822,239845
2022,7,19,체육대회,지출,1101,238744
2020,2,14,식사,지출,7540,231204
2023,5,19,여행,수입,9058,240262
2020,4,28,식사,수입,7026,247288
2020,10,13,여행,수입,9606,256894
2021,5,27,여행,지출,7337,249557
2022,12,11,여행,지출,3786,245771
2023,2,14,MT,지출,5578,240193
2023,6,3,식사,지출,5812,234381
2022,11,28,여행,지출,2500,231881
2022,3,17,체육대회,지출,6472,225409
2020,2,7,체육대회,수입,8085,233494
2020,1,5,쇼핑,지출,5960,227534
2021,1,28,여행,수입,5351,232885
2020,7,25,여행,수입,1982,234867
2020,9,20,체육대회,수입,4929,239796
2022,7,12,MT,수입,1957,241753
2023,10,21,체육대회,수입,2228,243981
2023,6,2,여행,지출,7420,236561
2020,9,30,식사,수입,8413,244974
2021,1,21,MT,지출,2117,242857
2023,9,2,여행,지출,7167,235690
2020,11,4,쇼핑,수입,4143,239833
2023,5,11,MT,수입,3230,243063
2023,3,10,쇼핑,지출,1467,241596
2020,7,24,체육대회,수입,8781,250377
2020,9,10,쇼핑,수입,4735,255112
2021,9,15,MT,수입,1731,256843
2023,9,7,식사,수입,2268,259111
2022,1,10,체육대회,지출,5325,253786
2021,6,21,MT,지출,7638,246148
2021,8,2,체육대회,수입,4661,250809
2021,6,29,체육대회,지출,7231,243578
2022,9,12,여행,지출,5127,238451
2023,2,16,MT,수입,1430,239881
2022,6,2,여행,지출,7029,232852
2023,1,22,식사,지출,2578,230274
2020,8,27,체육대회,지출,9626,220648
2020,12,2,체육대회,수입,1293,221941
2020,7,27,MT,지출,6074,215867
2021,5,17,식사,지출,4478,211389
2021,5,15,MT,수입,6285,217674
2021,2,20,MT,수입,4756,222430
2023,11,9,쇼핑,지출,1717,220713
2021,10,9,MT,수입,4799,225512
2022,2,9,식사,지출,3591,221921
2021,12,12,여행,수입,7591,229512
2022,1,22,여행,수입,1218,230730
2021,11,11,식사,수입,1475,232205
2023,2,6,여행,수입,2495,234700
2021,1,20,MT,수입,8416,243116
2020,1,3,체육대회,지출,3135,239981
2020,11,11,쇼핑,지출,5268,234713
2022,1,25,MT,수입,9605,244318
2022,7,3,식사,지출,7924,236394
2021,11,5,MT,수입,2178,238572
2022,8,15,MT,수입,2288,240860
2023,9,26,체육대회,지출,2958,237902
2022,7,7,식사,지출,2124,235778
2021,3,13,쇼핑,지출,5434,230344
2021,1,16,쇼핑,수입,4116,234460
2021,3,23,MT,지출,8820,225640
2022,11,15,MT,지출,7215,218425
2023,5,8,식사,지출,6612,211813
2021,10,17,쇼핑,수입,2617,214430
2023,1,21,체육대회,수입,7088,221518
2023,3,22,MT,수입,2427,223945
2020,12,5,쇼핑,수입,6225,230170
2023,2,16,체육대회,지출,2925,227245
2023,4,24,MT,수입,3517,230762
2023,8,29,여행,지출,6068,224694
2021,10,12,체육대회,수입,1707,226401
2021,4,29,MT,수입,7373,233774
2021,6,27,식사,수입,4919,238693
2020,8,31,MT,지출,5012,233681
2023,3,31,MT,수입,4931,238612
2023,1,30,MT,지출,8663,229949
2023,7,18,MT,지출,8486,221463
2023,5,25,쇼핑,지출,3719,217744
2021,7,13,체육대회,지출,9908,207836
2022,3,3,체육대회,수입,4744,212580
2022,11,1,쇼핑,수입,2748,215328
2020,9,3,쇼핑,수입,1748,217076
2022,9,17,식사,수입,6201,223277
2023,3,3,체육대회,수입,7724,231001
2023,2,1,쇼핑,수입,5044,236045
2022,2,22,식사,수입,3324,239369
2020,5,9,식사,지출,4287,235082
2023,7,18,MT,수입,2749,237831
2020,6,11,체육대회,지출,9252,228579
2023,5,9,식사,수입,1749,230328
2023,8,10,쇼핑,지출,9628,220700
2020,1,17,여행,수입,2097,222797
2021,5,2,식사,수입,9917,232714
2023,1,30,체육대회,지출,5130,227584
2020,12,29,MT,수입,2750,230334
2023,12,8,체육대회,수입,3312,233646
2023,9,26,체육대회,수입,9190,242836
2022,4,27,MT,수입,5678,248514
2022,8,2,여행,수입,3415,251929
2023,9,4,여행,수입,1478,253407
2022,6,29,식사,수입,7794,261201
2022,3,13,여행,수입,5323,266524
2021,5,18,MT,수입,4153,270677
2021,10,23,체육대회,지출,5968,264709
2022,10,22,MT,수입,8815,273524
2021,1,26,여행,지출,5343,268181
2020,5,12,여행,수입,1435,269616
2023,4,17,식사,지출,2216,267400
2021,3,24,MT,수입,9682,277082
2020,10,4,식사,지출,8555,268527
2023,8,13,식사,수입,3954,272481
2022,7,26,쇼핑,지출,7826,264655
2022,6,5,체육대회,수입,3399,268054
2021,9,14,MT,지출,7892,260162
2023,11,22,식사,수입,2796,262958
2023,11,19,쇼핑,수입,2965,265923
2023,8,11,MT,지출,5523,260400
2020,4,21,MT,지출,4370,256030
2023,4,21,식사,수입,9650,265680
2021,10,28,쇼핑,수입,6972,272652
2021,11,18,체육대회,수입,6806,279458
2022,11,9,식사,지출,6450,273008
2021,7,10,여행,지출,5954,267054
2023,9,7,체육대회,수입,5251,272305
2021,3,25,여행,지출,9069,263236
2021,8,18,체육대회,지출,7330,255906
2020,6,30,쇼핑,지출,4005,251901
2021,7,19,여행,지출,1433,250468
2020,2,20,식사,수입,8973,259441
2021,4,5,여행,수입,8674,268115
2022,11,14,MT,지출,8265,259850
2021,5,5,MT,지출,9935,249915
2021,11,25,체육대회,수입,3580,253495
2021,1,16,체육대회,지출,7273,246222
2020,12,5,MT,지출,2241,243981
2020,5,12,MT,수입,7700,251681
2023,3,6,여행,수입,9524,261205
2022,4,17,여행,수입,1774,262979
2021,3,29,쇼핑,수입,2085,265064
2023,6,8,식사,지출,5247,259817
2023,10,28,식사,수입,5357,265174
2022,11,24,쇼핑,수입,2315,267489
2022,1,3,MT,지출,7898,259591
2022,12,21,여행,수입,7103,266694
2020,6,19,여행,수입,9002,275696
2021,5,5,여행,지출,6257,269439
2021,2,22,쇼핑,지출,9551,259888
2022,4,9,여행,지출,7617,252271
2023,11,30,식사,수입,9296,261567
2021,9,17,식사,수입,4962,266529
2020,7,5,여행,지출,5342,261187
2022,6,29,체육대회,지출,8012,253175
2020,9,20,식사,수입,5292,258467
2021,8,4,MT,지출,2709,255758
2020,8,3,쇼핑,수입,7981,263739
2021,11,3,체육대회,수입,5947,269686
2020,11,14,체육대회,수입,2393,272079
2022,9,16,식사,수입,8898,280977
2021,10,8,식사,수입,2371,283348
2022,10,20,식사,지출,2821,280527
2020,10,5,체육대회,지출,3957,276570
2022,8,17,쇼핑,수입,7403,283973
2023,9,15,체육대회,지출,1711,282262
2023,5,13,MT,수입,4101,286363
2021,11,19,식사,수입,4548,290911
2021,4,19,쇼핑,수입,9851,300762
2021,3,2,여행,지출,4478,296284
2022,11,16,식사,수입,8815,305099
2022,8,9,식사,지출,3862,301237
2020,3,28,MT,지출,4029,297208
2022,2,9,쇼핑,지출,5675,291533
2021,7,21,MT,지출,4576,286957
2023,8,31,체육대회,지출,7263,279694
2022,1,26,MT,지출,6634,273060
2023,10,28,체육대회,지출,2081,270979
2022,6,16,여행,지출,5120,265859
2020,2,12,쇼핑,지출,8627,257232
2021,9,14,MT,지출,5753,251479
2021,12,4,쇼핑,수입,5663,257142
2022,2,21,쇼핑,지출,5945,251197
2021,2,6,MT,지출,5474,245723
2020,6,9,MT,수입,1921,247644
2021,6,23,MT,지출,4089,243555
2020,10,3,MT,수입,3112,246667
2022,2,4,MT,수입,8895,255562
2021,5,18,MT,지출,8224,247338
2022,3,8,식사,지출,2482,244856
2023,7,2,쇼핑,지출,7189,237667
2020,5,1,체육대회,지출,1578,236089
2021,2,11,여행,수입,9450,245539
2022,7,27,식사,지출,7928,237611
2023,8,4,체육대회,수입,1064,238675
2020,6,7,체육대회,수입,7268,245943
2021,9,29,MT,수입,8671,254614
2021,7,24,식사,수입,8867,263481
2021,8,26,쇼핑,수입,8741,272222
2023,1,11,식사,수입,4943,277165
2023,2,28,여행,수입,8707,285872
2021,5,28,쇼핑,수입,8304,294176
2022,4,11,여행,수입,1950,296126
2021,3,23,MT,수입,8953,305079
2023,6,20,식사,지출,2391,302688
2021,9,16,체육대회,수입,4093,306781
2020,5,16,쇼핑,수입,7122,313903
2022,9,2,쇼핑,수입,4037,317940
2022,10,17,MT,수입,8057,325997
2022,1,11,쇼핑,지출,1099,324898
2020,5,28,MT,지출,2992,321906
2022,5,28,쇼핑,지출,5091,316815
2023,5,12,여행,지출,7533,309282
2021,11,3,체육대회,지출,2413,306869
2020,8,18,식사,지출,2728,304141
2023,10,30,쇼핑,지출,6208,297933
2021,3,7,쇼핑,지출,2917,295016
2020,5,19,MT,수입,1864,296880
2022,6,14,식사,수입,4765,301645
2021,6,25,식사,수입,7535,309180
2022,11,7,쇼핑,지출,9027,300153
2022,8,31,MT,수입,4632,304785
2022,6,23,체육대회,지출,7673,297112
2023,12,30,식사,지출,2207,294905
2020,3,19,식사,지출,4071,290834
2022,3,16,여행,지출,5085,285749
2021,12,17,여행,수입,8003,293752
2023,12,29,MT,지출,7640,286112
2020,4,22,식사,지출,3615,282497
2021,8,24,MT,지출,6376,276121
2020,12,9,쇼핑,수입,5723,281844
2020,11,8,MT,수입,3980,285824
2020,7,3,여행,수입,6469,292293
2023,4,28,식사,지출,8585,283708
2023,6,11,여행,지출,3645,280063
2023,12,11,체육대회,수입,9231,289294
2020,4,12,식사,수입,9443,298737
2020,7,26,식사,수입,7574,306311
2020,5,20,식사,지출,2391,303920
2022,5,14,체육대회,수입,6414,310334
2023,6,24,MT,지출,1639,308695
2023,7,14,쇼핑,지출,2062,306633
2020,12,29,MT,수입,5900,312533
2021,2,27,쇼핑,수입,2265,314798
2023,4,17,여행,지출,3446,311352
2023,8,1,MT,지출,4485,306867
2023,11,26,체육대회,수입,5590,312457
2022,6,26,식사,지출,7250,305207
2022,9,5,여행,지출,5168,300039
2023,12,27,여행,지출,4161,295878
2023,11,7,식사,수입,7250,303128
2021,11,8,쇼핑,수입,2963,306091
2020,6,21,여행,수입,3984,310075
2021,11,24,체육대회,수입,4250,314325
2022,12,16,여행,지출,3347,310978
2022,11,29,여행,수입,5326,316304
2021,9,22,식사,지출,4995,311309
2023,7,17,MT,수입,7007,318316
2023,1,9,MT,지출,7886,310430
2022,7,18,식사,수입,1879,312309
2023,1,29,체육대회,수입,7948,320257
2020,3,3,여행,지출,7113,313144
2020,11,28,체육대회,지출,1702,311442
2022,2,24,식사,수입,8402,319844
2021,12,30,여행,수입,9788,329632
2020,4,24,체육대회,수입,9525,339157
2022,1,17,여행,수입,7801,346958
2021,12,27,쇼핑,수입,9921,356879
2022,12,17,체육대회,지출,6896,349983
2021,12,10,식사,수입,5346,355329
2020,6,5,MT,지출,4296,351033
2022,6,13,MT,수입,1156,352189
2020,3,7,체육대회,지출,9451,342738
2022,5,30,식사,지출,2778,339960
2023,2,11,여행,수입,3211,343171
2021,9,24,MT,지출,7640,335531
2021,6,22,식사,지출,7340,328191
2020,7,15,체육대회,수입,8933,337124
2023,10,30,여행,수입,2247,339371
2023,4,23,체육대회,수입,1417,340788
2022,6,30,쇼핑,수입,5653,346441
2023,7,4,쇼핑,수입,7690,354131
2023,3,28,식사,지출,7995,346136
2023,9,8,여행,수입,1494,347630
2020,6,7,식사,수입,3188,350818
2021,5,31,체육대회,수입,4510,355328
2020,4,8,체육대회,수입,7149,362477
2021,10,28,쇼핑,수입,8677,371154
2021,5,2,MT,지출,9136,362018
2023,7,2,식사,지출,5582,356436
2021,7,8,MT,지출,4311,352125
2023,10,14,쇼핑,지출,3575,348550
2021,6,2,식사,수입,2438,350988
2023,5,6,MT,지출,7923,343065
2023,12,24,식사,수입,1365,344430
2021,10,2,MT,지출,9456,334974
2021,8,23,체육대회,수입,8836,343810
2023,4,9,MT,지출,5166,338644
2023,6,25,식사,지출,6320,332324
2021,2,1,여행,지출,1690,330634
2020,9,18,MT,지출,4163,326471
2023,1,20,쇼핑,지출,7505,318966
2023,5,19,MT,지출,3937,315029
2023,9,7,식사,수입,4279,319308
2023,3,5,쇼핑,수입,4975,324283
2022,11,24,체육대회,지출,7050,317233
2023,8,20,체육대회,지출,1003,316230
2021,1,14,체육대회,수입,2608,318838
2022,10,31,식사,수입,5635,324473
2020,6,3,쇼핑,지출,5484,318989
2022,9,8,체육대회,지출,2673,316316
2021,9,28,식사,수입,4081,320397
2022,9,26,쇼핑,지출,3048,317349
2023,3,11,쇼핑,수입,1120,318469
2020,2,11,식사,지출,5422,313047
2023,6,12,체육대회,지출,3318,309729
2023,5,15,여행,지출,6012,303717
2020,5,1,여행,수입,6439,310156
2021,1,14,식사,수입,8100,318256
2020,3,28,식사,수입,1550,319806
2023,10,23,여행,지출,4932,314874
2022,7,25,여행,지출,8783,306091
2022,12,16,체육대회,수입,1283,307374
2020,12,13,식사,지출,9186,298188
2022,12,2,MT,수입,9593,307781
2021,8,20,체육대회,지출,6805,300976
2021,6,26,식사,수입,9455,310431
2023,8,18,쇼핑,지출,4688,305743
2022,10,23,쇼핑,수입,9459,315202
2020,1,7,쇼핑,수입,8946,324148
2020,2,4,여행,수입,5521,329669
2021,12,2,쇼핑,수입,8075,337744
2023,4,20,MT,수입,5007,342751
2020,7,3,식사,지출,2622,340129
2022,2,9,MT,수입,3149,343278
2020,8,8,쇼핑,지출,9947,333331
2023,10,20,MT,수입,9811,343142
2023,8,20,여행,수입,1190,344332
2021,6,17,여행,수입,5103,349435
2021,7,16,여행,수입,7789,357224
2022,11,13,식사,수입,2022,359246
2022,3,24,MT,지출,9348,349898
2022,3,21,식사,지출,1742,348156
2020,10,12,체육대회,지출,4975,343181
2021,12,27,쇼핑,수입,6045,349226
2022,2,6,쇼핑,지출,9388,339838
2021,7,15,쇼핑,지출,3779,336059
2022,5,27,여행,수입,9715,345774
2022,7,15,쇼핑,수입,2589,348363
2022,6,4,여행,지출,1352,347011
2020,9,4,MT,수입,8956,355967
2022,2,2,여행,지출,7555,348412
2020,6,12,식사,지출,7102,341310
2023,6,18,체육대회,지출,4026,337284
2022,7,30,체육대회,수입,2557,339841
2022,2,4,식사,수입,6662,346503
2023,5,22,MT,지출,4477,342026
2021,8,3,쇼핑,수입,5395,347421
2023,8,13,쇼핑,지출,2256,345165
2021,8,15,체육대회,수입,9318,354483
2022,12,2,쇼핑,지출,8884,345599
2021,6,6,체육대회,지출,6892,338707
2021,11,22,MT,수입,5457,344164
2021,4,28,여행,지출,7887,336277
2021,5,16,여행,수입,1567,337844
2023,4,12,여행,수입,3620,341464
2021,7,19,MT,수입,8359,349823
2021,11,17,여행,수입,7565,357388
2021,5,11,식사,수입,7475,364863
2020,8,9,체육대회,수입,7325,372188
2023,11,30,식사,수입,1431,373619
2021,12,21,식사,수입,5952,379571
2022,8,20,여행,수입,6710,386281
2020,10,9,쇼핑,수입,6098,392379
2022,7,30,여행,지출,9353,383026
2021,3,3,쇼핑,지출,6022,377004
2022,12,30,MT,지출,7634,369370
2023,9,28,식사,지출,5588,363782
2023,10,21,여행,수입,9480,373262
2023,4,1,쇼핑,수입,7735,380997
2020,7,31,쇼핑,지출,4187,376810
2022,12,19,MT,지출,1996,374814
2023,7,14,MT,수입,1662,376476
2023,7,16,MT,수입,6154,382630
2022,10,31,MT,수입,2336,384966
2023,7,3,MT,지출,6552,378414
2023,5,26,체육대회,지출,3581,374833
2023,11,17,체육대회,수입,4919,379752
2023,11,7,여행,수입,6794,386546
2021,2,5,식사,지출,4461,382085
2023,11,13,MT,지출,6501,375584
2021,10,12,체육대회,지출,5173,370411
2020,3,4,여행,지출,3225,367186
2021,5,10,식사,수입,6262,373448
2023,4,14,체육대회,수입,4006,377454
2022,10,10,체육대회,수입,9745,387199
2023,12,5,여행,수입,1446,388645
2022,11,5,MT,지출,2293,386352
2020,10,27,식사,수입,8180,394532
2021,5,29,식사,수입,2868,397400
2021,3,5,여행,수입,2122,399522
2020,8,7,여행,지출,1023,398499
2021,2,26,쇼핑,지출,9207,389292
2023,5,14,MT,지출,9007,380285
2022,7,12,식사,지출,1590,378695
2023,7,3,여행,수입,5621,384316
2022,12,7,MT,지출,8435,375881
2021,4,28,MT,수입,6651,382532
2020,2,26,여행,지출,3252,379280
2021,10,3,여행,수입,7337,386617
2020,8,31,여행,지출,2414,384203
2020,9,10,MT,지출,8420,375783
2020,10,19,MT,수입,6046,381829
2022,5,18,쇼핑,지출,6465,375364
2022,4,7,체육대회,지출,8879,366485
2020,11,9,체육대회,수입,6402,372887
2021,4,4,식사,지출,5015,367872
2020,2,2,MT,지출,8227,359645
2023,6,25,식사,수입,8531,368176
2023,8,12,체육대회,지출,4359,363817
2023,8,13,여행,지출,1884,361933
2021,1,15,체육대회,지출,4123,357810
2022,9,24,쇼핑,지출,9156,348654
2022,3,18,체육대회,수입,1956,350610
2021,10,21,체육대회,수입,7109,357719
2021,11,15,체육대회,수입,2341,360060
2022,6,23,체육대회,지출,3859,356201
2020,4,29,식사,지출,9554,346647
2023,9,18,MT,수입,7234,353881
2022,10,27,식사,지출,9212,344669
2020,9,4,여행,수입,9215,353884
2020,8,29,식사,지출,6417,347467
2023,1,23,쇼핑,지출,3205,344262
2020,7,4,MT,지출,4938,339324
2022,6,2,식사,지출,5400,333924
2023,6,25,식사,수입,9582,343506
2021,11,23,MT,지출,8661,334845
2021,9,20,쇼핑,지출,6463,328382
2020,1,26,여행,수입,9905,338287
2020,4,5,체육대회,지출,2411,335876
2020,6,28,MT,수입,4043,339919
2021,11,3,체육대회,지출,3679,336240
2020,11,28,쇼핑,지출,5529,330711
2020,12,11,MT,수입,9986,340697
2021,12,23,MT,수입,6358,347055
2022,6,10,MT,지출,4450,342605
2022,3,19,체육대회,지출,6944,335661
2023,9,28,여행,지출,2327,333334
2023,10,27,쇼핑,수입,7141,340475
2022,5,13,쇼핑,지출,5844,334631
2021,8,29,MT,지출,7229,327402
2021,5,19,MT,지출,2100,325302
2023,10,18,MT,지출,1857,323445
2020,10,27,쇼핑,수입,6136,329581
2022,5,17,쇼핑,수입,6158,335739
2022,1,3,MT,지출,2727,333012
2023,8,4,쇼핑,수입,3256,336268
2020,8,22,쇼핑,지출,3561,332707
2021,8,8,MT,수입,8047,340754
2023,5,15,여행,수입,8971,349725
2021,10,24,여행,지출,2551,347174
2020,3,15,여행,지출,5664,341510
2023,10,24,쇼핑,수입,8097,349607
2021,3,31,MT,수입,6443,356050
2020,11,20,체육대회,지출,9270,346780
2022,9,21,MT,수입,1491,348271
2020,8,14,체육대회,수입,7557,355828
2020,12,8,식사,지출,4516,351312
2020,2,4,MT,수입,3621,354933
2023,1,23,쇼핑,지출,5564,349369
2023,11,19,식사,수입,5797,355166
2021,9,22,체육대회,수입,7158,362324
2021,6,27,쇼핑,수입,3398,365722
2022,7,16,여행,지출,6196,359526
2021,6,7,쇼핑,지출,3337,356189
2023,5,31,체육대회,지출,6946,349243
2021,4,15,식사,수입,4070,353313
2023,4,9,식사,지출,4847,348466
2023,2,19,체육대회,수입,1101,349567
2020,8,4,식사,지출,2322,347245
2021,2,16,식사,수입,8125,355370
2021,4,29,체육대회,수입,4156,359526
2021,2,16,체육대회,수입,1278,360804
2021,5,20,MT,지출,2082,358722
2020,6,2,식사,수입,3530,362252
2022,7,22,쇼핑,지출,4836,357416
2020,9,23,쇼핑,지출,3572,353844
2022,10,30,여행,지출,2734,351110
2020,6,9,쇼핑,지출,9365,341745
2020,10,24,여행,수입,1421,343166
2022,7,11,체육대회,수입,3858,347024
2021,7,7,체육대회,수입,4702,351726
2022,8,19,식사,지출,2641,349085
2022,2,5,체육대회,지출,9765,339320
2023,11,25,쇼핑,지출,9470,329850
2020,10,5,체육대회,지출,4361,325489
2023,2,25,식사,지출,1100,324389
2023,3,3,쇼핑,지출,8599,315790
2022,12,3,식사,지출,1511,314279
2021,10,13,식사,수입,7490,321769
2023,2,17,여행,지출,2606,319163
2021,12,23,체육대회,수입,2207,321370
2023,1,27,식사,수입,7401,328771
2023,1,26,체육대회,수입,4105,332876
2020,4,29,식사,수입,8938,341814
2020,1,30,여행,수입,7417,349231
2022,4,29,여행,지출,5343,343888
2020,6,24,쇼핑,지출,3399,340489
2023,3,15,쇼핑,지출,6194,334295
2020,9,29,여행,수입,7598,341893
2021,4,10,MT,수입,8263,350156
2023,1,30,쇼핑,지출,4473,345683
2023,6,22,체육대회,지출,1687,343996
2021,4,6,MT,수입,3376,347372
2023,5,21,여행,수입,6215,353587
2020,10,18,여행,수입,1741,355328
2021,7,30,MT,지출,3135,352193
2021,6,11,식사,수입,9116,361309
2020,10,17,MT,수입,6118,367427
2020,3,13,MT,수입,4375,371802
2022,4,30,여행,수입,9161,380963
2023,3,23,식사,지출,3935,377028
2020,4,25,여행,지출,5368,371660
2022,12,7,쇼핑,지출,2933,368727
2022,10,20,쇼핑,지출,1691,367036
2021,2,10,체육대회,수입,8087,375123
2020,2,1,MT,수입,4439,379562
2021,10,14,쇼핑,수입,8117,387679
2021,9,14,체육대회,수입,9786,397465
2021,3,13,여행,지출,6947,390518
2020,11,6,여행,지출,2794,387724
2023,8,30,MT,수입,6980,394704
2023,9,23,MT,수입,7859,402563
2020,3,31,여행,지출,5859,396704
2021,7,8,식사,수입,8515,405219
2023,6,28,여행,지출,2415,402804
2021,2,1,MT,지출,1565,401239
2020,3,1,체육대회,수입,1056,402295
2022,2,12,식사,수입,2861,405156
2021,6,15,체육대회,지출,4690,400466
2023,9,28,체육대회,지출,7749,392717
2021,2,21,식사,지출,5015,387702
2023,8,31,여행,지출,8269,379433
2023,1,26,MT,수입,4696,384129
2023,11,1,여행,수입,4123,388252
2020,1,2,쇼핑,지출,2594,385658
2021,11,17,식사,지출,9881,375777
2022,1,1,쇼핑,수입,8261,384038
2020,12,25,식사,수입,4990,389028
2020,6,7,쇼핑,수입,9851,398879
2023,11,2,여행,수입,2257,401136
2021,3,13,체육대회,수입,4158,405294
2023,5,17,식사,수입,8959,414253
2021,6,18,MT,수입,4844,419097
2020,2,20,식사,지출,6828,412269
2021,3,14,식사,수입,6893,419162
2020,6,24,MT,수입,9876,429038
2020,2,2,MT,지출,9826,419212
2020,2,11,쇼핑,지출,4768,414444
2020,11,22,체육대회,수입,9349,423793
2023,3,15,쇼핑,지출,4549,419244
2022,10,7,체육대회,지출,3586,415658
2022,9,25,체육대회,수입,2487,418145
2022,11,2,쇼핑,수입,5303,423448
2022,7,24,MT,지출,3350,420098
2023,2,26,여행,수입,6840,426938
2020,5,1,쇼핑,지출,8035,418903
2020,8,17,쇼핑,지출,3657,415246
2023,1,29,체육대회,지출,8249,406997
2023,5,23,MT,지출,2818,404179
2021,4,5,여행,지출,5352,398827
2020,7,26,여행,지출,2121,396706
2021,5,1,MT,수입,1214,397920
2021,11,15,체육대회,지출,3237,394683
2021,7,11,MT,지출,6132,388551
2022,3,2,식사,수입,3511,392062
2023,9,16,여행,지출,4556,387506
2020,12,18,식사,지출,6055,381451
2021,1,16,식사,지출,5933,375518
2021,11,22,쇼핑,수입,6107,381625
2021,12,18,체육대회,지출,1432,380193
2020,6,10,쇼핑,지출,2832,377361
2023,10,26,MT,지출,2978,374383
2021,6,1,체육대회,수입,8197,382580
2023,5,6,여행,수입,2138,384718
2023,9,23,쇼핑,수입,1117,385835
2021,4,2,쇼핑,지출,7640,378195
2021,6,15,MT,지출,8718,369477
2021,1,27,체육대회,지출,6174,363303
2022,6,16,식사,수입,9872,373175
2022,5,17,쇼핑,지출,6270,366905
2020,8,8,식사,지출,5973,360932
2022,2,7,쇼핑,지출,4452,356480
2022,5,3,MT,수입,7402,363882
2020,3,19,MT,지출,3259,360623
2022,6,28,쇼핑,수입,9685,370308
2023,4,5,MT,수입,3085,373393
2021,4,26,쇼핑,지출,6497,366896
2023,11,3,쇼핑,지출,7226,359670
2022,5,25,쇼핑,수입,6632,366302
2022,4,4,쇼핑,수입,3997,370299
2020,1,16,쇼핑,수입,2188,372487
2021,10,8,여행,지출,1282,371205
2023,10,3,MT,수입,3677,374882
2023,2,5,쇼핑,지출,1613,373269
2022,3,24,식사,지출,4467,368802
2022,6,5,여행,수입,2927,371729
2023,7,20,MT,지출,7508,364221
2020,5,29,여행,수입,1038,365259
2020,3,4,쇼핑,수입,1700,366959
2020,4,19,쇼핑,지출,5745,361214
2021,8,8,쇼핑,지출,5801,355413
2021,10,20,체육대회,수입,7985,363398
2022,4,19,MT,수입,2430,365828
2021,4,2,여행,수입,7191,373019
2022,10,25,체육대회,수입,4649,377668
2022,2,14,식사,수입,5884,383552
2023,6,14,체육대회,수입,4000,387552
2021,8,6,쇼핑,수입,9140,396692
2023,8,10,쇼핑,수입,5606,402298
2021,12,25,식사,지출,5848,396450
2021,4,30,식사,수입,2478,398928
2021,11,8,식사,수입,1320,400248
2020,7,8,쇼핑,지출,5501,394747
2023,7,7,MT,지출,3852,390895
2023,7,9,식사,수입,4844,395739
2020,11,24,체육대회,지출,3702,392037
2021,4,5,쇼핑,수입,7310,399347
2023,12,30,식사,지출,7417,391930
2021,6,2,체육대회,수입,6693,398623
2020,9,11,여행,수입,4923,403546
2021,12,18,MT,지출,2790,400756
2021,11,25,쇼핑,수입,7502,408258
2022,10,17,여행,수입,7069,415327
2023,5,21,체육대회,지출,8132,407195
2022,3,13,식사,수입,4944,412139
2023,8,5,MT,지출,3708,408431
2021,5,9,MT,수입,8296,416727
2022,8,22,MT,지출,6449,410278
2021,5,9,식사,지출,1822,408456
2021,3,21,MT,지출,2307,406149
2021,8,3,식사,지출,9057,397092
2023,2,24,식사,수입,2221,399313
2023,8,25,식사,지출,9176,390137
2021,7,14,식사,지출,7524,382613
2023,11,30,여행,지출,8597,374016
2020,3,4,MT,지출,5306,368710
2023,5,31,식사,수입,8048,376758
2021,12,22,MT,수입,3954,380712
2021,8,21,체육대회,수입,9409,390121
2022,1,23,체육대회,수입,8107,398228
2023,7,21,체육대회,수입,8198,406426
2023,3,20,식사,지출,6010,400416
2020,11,16,체육대회,수입,3661,404077
2022,9,13,체육대회,수입,9800,413877
2021,5,8,여행,수입,1942,415819
2020,11,13,식사,수입,3297,419116
2023,11,3,쇼핑,수입,5910,425026
2021,2,4,식사,수입,9804,434830
2022,10,22,체육대회,지출,5888,428942
2021,6,18,MT,수입,3627,432569
2021,8,25,여행,수입,7965,440534
2023,12,26,MT,지출,1130,439404
2020,4,28,식사,수입,5359,444763
2020,4,30,쇼핑,수입,3649,448412
2021,1,31,MT,수입,3428,451840
2021,9,10,MT,수입,5851,457691
2021,7,8,여행,수입,9195,466886
2021,1,9,쇼핑,지출,2628,464258
2022,6,16,여행,지출,9840,454418
2020,5,28,쇼핑,수입,2344,456762
2021,11,30,여행,수입,6310,463072
2023,10,27,체육대회,지출,2908,460164
2020,1,4,여행,지출,3112,457052
2020,1,31,식사,수입,8975,466027
2020,3,15,여행,수입,6702,472729
2022,11,15,MT,지출,4620,468109
2020,5,5,쇼핑,수입,7653,475762
2022,1,14,체육대회,수입,3840,479602
2020,3,24,식사,수입,1944,481546
2020,3,14,여행,수입,1823,483369
2020,2,13,체육대회,지출,3006,480363
2021,9,29,쇼핑,수입,3024,483387
2021,3,1,MT,지출,4401,478986
2021,10,28,MT,지출,7466,471520
2023,3,2,식사,지출,6964,464556
2022,1,22,MT,수입,5220,469776
2021,9,6,여행,수입,2329,472105
2022,12,15,MT,수입,2953,475058
2022,7,1,여행,수입,3819,478877
2022,4,3,여행,지출,7365,471512
2023,11,28,체육대회,수입,3379,474891
2023,5,20,식사,지출,4263,470628
2021,3,7,쇼핑,수입,5112,475740
2020,10,26,MT,지출,8154,467586
2021,10,17,MT,수입,2595,470181
2023,1,5,식사,수입,4829,475010
2021,7,14,체육대회,지출,1169,473841
2022,4,3,여행,수입,3454,477295
2022,11,19,MT,지출,6859,470436
2022,2,20,쇼핑,수입,2988,473424
2021,8,23,MT,수입,7059,480483
2023,12,20,체육대회,지출,2797,477686
2023,10,29,체육대회,수입,6655,484341
2022,7,21,쇼핑,수입,4105,488446
2020,9,17,MT,지출,4628,483818
2023,10,4,여행,수입,9068,492886
2020,1,15,쇼핑,수입,5210,498096
2022,6,13,쇼핑,지출,2504,495592
2020,10,14,식사,지출,1354,494238
2022,9,28,식사,지출,4318,489920
2021,4,14,체육대회,지출,9530,480390
2023,6,19,MT,지출,5097,475293
2020,12,13,여행,지출,9505,465788
2022,1,5,체육대회,수입,3769,469557
2023,10,15,식사,수입,9333,478890
2022,10,16,쇼핑,수입,9874,488764
2021,1,9,식사,지출,7625,481139
2023,4,19,쇼핑,수입,6227,487366
2022,5,15,체육대회,지출,3996,483370
2021,12,13,체육대회,지출,8950,474420
2021,12,18,여행,수입,2090,476510
2022,3,18,쇼핑,수입,3079,479589
2023,10,18,여행,지출,6785,472804
2021,10,30,MT,수입,7719,480523
2020,1,7,쇼핑,수입,7353,487876
2020,6,15,체육대회,수입,2957,490833
2022,11,8,여행,지출,9232,481601
2022,6,3,MT,지출,5713,475888
2020,5,27,식사,지출,5434,470454
2021,10,11,식사,지출,4425,466029
2022,3,22,MT,지출,3723,462306
2021,11,14,여행,수입,4777,467083
2021,5,28,체육대회,수입,2749,469832
2023,7,17,쇼핑,수입,4499,474331
2021,9,11,쇼핑,지출,4932,469399
2020,6,15,쇼핑,수입,9653,479052
2021,10,21,식사,지출,2081,476971
2023,2,13,MT,지출,3100,473871
2022,1,9,식사,수입,1357,475228
2022,6,25,쇼핑,지출,9846,465382
2022,4,28,식사,수입,7454,472836
2022,11,10,MT,지출,8666,464170
2020,11,10,체육대회,수입,2958,467128
2022,9,5,MT,수입,1261,468389
2020,1,5,체육대회,수입,6199,474588
2023,8,27,여행,지출,5679,468909
2021,12,5,쇼핑,수입,9495,478404
2023,12,6,식사,수입,4841,483245
2021,3,22,MT,지출,1587,481658
2022,2,13,식사,지출,1471,480187
2023,4,5,MT,지출,2584,477603
2021,4,28,식사,수입,1341,478944
2020,1,10,MT,수입,2050,480994
2021,7,15,MT,지출,9611,471383
2023,11,23,쇼핑,지출,3889,467494
2020,2,10,식사,지출,1625,465869
2023,9,30,여행,수입,1103,466972
2022,7,8,식사,지출,6182,460790
2022,7,6,쇼핑,수입,3165,463955
2021,11,1,식사,수입,4737,468692
2023,11,12,MT,수입,5363,474055
2020,6,17,MT,지출,4341,469714
2023,9,16,MT,지출,2650,467064
2023,8,5,쇼핑,수입,6996,474060
2023,11,27,체육대회,지출,8898,465162
2023,8,26,식사,수입,4145,469307
2021,4,29,식사,수입,4142,473449
2023,2,3,쇼핑,수입,8487,481936
2021,12,12,쇼핑,지출,3150,478786
2022,10,24,여행,지출,9475,469311
2020,1,9,체육대회,수입,4708,474019
2020,5,22,여행,지출,4092,469927
2020,7,19,여행,수입,3961,473888
2021,12,28,체육대회,수입,5663,479551
2021,5,15,MT,지출,3415,476136
2022,1,13,MT,수입,1325,477461
2020,8,6,체육대회,수입,1005,478466
2022,7,17,체육대회,지출,2648,475818
2020,8,12,MT,수입,5556,481374
2023,5,8,체육대회,지출,8200,473174
2020,12,26,MT,지출,3560,469614
2020,5,27,MT,수입,2049,471663
2023,9,22,쇼핑,지출,5252,466411
2023,4,30,체육대회,수입,5420,471831
2020,8,5,쇼핑,지출,7432,464399
2023,11,23,식사,수입,2237,466636
2023,11,20,식사,지출,8821,457815
2020,4,5,쇼핑,지출,4751,453064
2021,9,5,체육대회,수입,8015,461079
2020,11,22,쇼핑,지출,1871,459208
2022,5,13,쇼핑,수입,3766,462974
2022,8,16,MT,수입,4993,467967
2023,6,5,식사,지출,2609,465358
2023,10,2,여행,지출,6972,458386
2022,6,21,체육대회,지출,7639,450747
2022,5,1,여행,지출,2961,447786
2023,2,16,식사,지출,8504,439282
2022,10,11,여행,지출,9281,430001
2022,5,21,쇼핑,수입,6925,436926
2022,1,12,여행,수입,2105,439031
2021,2,19,여행,수입,1008,440039
2021,4,18,여행,지출,5557,434482
2022,8,7,쇼핑,수입,9070,443552
2021,7,26,여행,수입,8662,452214
2021,8,10,식사,수입,1193,453407
2023,12,7,여행,지출,3122,450285
2020,2,20,여행,지출,2346,447939
2021,9,20,여행,지출,5372,442567
2022,5,8,MT,수입,4727,447294
2021,5,30,여행,지출,5006,442288
2023,6,24,MT,수입,6143,448431
2022,8,4,체육대회,지출,7629,440802
2023,10,25,식사,지출,8270,432532
2023,6,5,여행,수입,8392,440924
2021,4,18,식사,지출,6516,434408
2023,6,24,여행,지출,2633,431775
2021,2,8,체육대회,지출,6437,425338
2022,9,16,MT,지출,9230,416108
2022,12,9,식사,수입,1642,417750
2022,10,23,MT,수입,3095,420845
2022,6,18,식사,수입,9777,430622
2023,11,13,쇼핑,수입,7882,438504
2022,9,23,식사,지출,2315,436189
2021,9,15,체육대회,지출,3161,433028
2020,7,6,식사,수입,2338,435366
2023,8,1,식사,지출,5138,430228
2022,11,22,체육대회,수입,1626,431854
2020,8,17,여행,수입,6078,437932
2022,6,6,식사,지출,1234,436698
2020,3,26,식사,지출,7138,429560
2021,11,4,식사,수입,7599,437159
2022,9,3,쇼핑,수입,4201,441360
2022,2,27,쇼핑,수입,7851,449211
2020,11,11,쇼핑,지출,1908,447303
2021,1,14,체육대회,지출,6207,441096
2020,10,11,여행,지출,7510,433586
2022,12,7,MT,지출,7601,425985
2023,10,7,식사,수입,8128,434113
2020,4,30,여행,수입,4952,439065
2020,2,9,쇼핑,수입,9912,448977
2023,10,24,MT,지출,2241,446736
2021,12,29,체육대회,수입,4084,450820
2022,5,15,여행,수입,1556,452376
2021,8,29,MT,지출,8343,444033
2022,7,27,여행,수입,9297,453330
2020,8,3,식사,지출,3277,450053
2020,7,5,쇼핑,수입,8368,458421
2020,5,8,MT,수입,3205,461626
2023,7,22,체육대회,지출,9529,452097
2021,2,2,쇼핑,수입,5820,457917
2020,8,12,식사,지출,5368,452549
2023,12,25,식사,수입,8011,460560
2021,7,28,MT,지출,6671,453889
2022,5,10,체육대회,지출,6617,447272
2022,12,8,MT,지출,4932,442340
2022,8,4,체육대회,수입,4777,447117
2023,11,4,여행,수입,8428,455545
2020,7,17,체육대회,지출,1768,453777
2020,4,9,MT,수입,6016,459793
2020,12,3,식사,수입,5560,465353
2021,12,24,체육대회,지출,8270,457083
2022,1,23,체육대회,수입,1583,458666
2020,11,19,체육대회,수입,2582,461248
2021,1,9,여행,수입,8321,469569
2021,11,23,쇼핑,지출,4302,465267
2023,10,31,MT,수입,5878,471145
2021,7,26,식사,수입,3958,475103
2022,11,23,여행,지출,5214,469889
2021,5,27,여행,지출,3255,466634
2020,7,12,쇼핑,지출,8120,458514
2022,4,4,식사,지출,8578,449936
2020,12,18,여행,수입,9029,458965
2021,4,2,식사,수입,7608,466573
2023,10,14,여행,수입,1821,468394
2022,1,5,식사,수입,4134,472528
2020,11,6,MT,수입,9165,481693
2022,10,16,여행,수입,3904,485597
2021,1,27,여행,수입,5369,490966
2021,12,8,식사,지출,1322,489644
2023,3,10,체육대회,지출,6739,482905
2020,6,29,MT,수입,4482,487387
2022,1,31,여행,수입,4226,491613
2022,3,21,식사,수입,6567,498180
2020,8,12,체육대회,지출,6197,491983
2022,4,19,식사,수입,5141,497124
2020,5,8,쇼핑,수입,5734,502858
2023,9,29,식사,수입,8149,511007
2021,9,15,식사,지출,2581,508426
2022,6,29,식사,지출,7523,500903
2022,4,29,쇼핑,수입,2424,503327
2022,11,18,식사,수입,8110,511437
2023,6,1,MT,수입,2217,513654
2023,8,14,식사,수입,7883,521537
2020,7,22,쇼핑,지출,6565,514972
2021,8,13,식사,지출,3718,511254
2020,2,16,여행,지출,1743,509511
2023,3,2,식사,지출,2828,506683
2022,1,31,여행,지출,9561,497122
2022,9,10,식사,수입,9635,506757
2021,12,17,식사,지출,4951,501806
2020,1,19,체육대회,수입,3156,504962
2022,7,22,체육대회,지출,9198,495764
2022,7,25,체육대회,지출,7046,488718
2022,7,20,MT,지출,1527,487191
2022,5,14,MT,지출,5363,481828
2021,7,12,여행,지출,3690,478138
2022,6,13,체육대회,지출,6912,471226
2021,2,1,쇼핑,지출,2472,468754
2023,3,17,여행,지출,6261,462493
2023,2,24,쇼핑,수입,4679,467172
2020,11,26,쇼핑,지출,4740,462432
2023,4,8,체육대회,지출,8922,453510
2022,2,22,MT,수입,3908,457418
2023,9,20,식사,수입,1319,458737
2020,11,29,여행,수입,8992,467729
2020,7,12,식사,수입,9702,477431
2020,10,6,체육대회,지출,7525,469906
2021,4,8,식사,지출,7640,462266
2022,6,17,체육대회,수입,4612,466878
2021,1,5,식사,수입,5842,472720
2020,3,13,여행,수입,9178,481898
2022,5,9,쇼핑,수입,3063,484961
2022,6,8,여행,지출,3074,481887
2023,3,10,MT,지출,7503,474384
2021,4,6,식사,지출,7840,466544
2021,4,12,쇼핑,지출,3796,462748
2021,3,20,식사,수입,5848,468596
2023,1,6,식사,수입,7193,475789
2023,2,7,식사,수입,7603,483392
2022,12,29,체육대회,지출,7389,476003
2022,12,13,여행,수입,6909,482912
2021,5,8,MT,지출,1559,481353
2022,4,2,MT,수입,8112,489465
2023,5,15,여행,지출,1234,488231
2021,9,1,식사,지출,3448,484783
2020,2,1,여행,지출,9731,475052
2022,6,4,식사,수입,8076,483128
2020,7,7,여행,지출,3547,479581
2022,9,25,쇼핑,수입,7954,487535
2021,5,30,쇼핑,지출,1458,486077
2022,2,14,쇼핑,수입,6540,492617
2022,12,17,체육대회,수입,9475,502092
2022,10,6,체육대회,수입,6602,508694
2023,10,2,MT,지출,5998,502696
2022,1,11,여행,지출,5099,497597
2021,7,29,여행,지출,7832,489765
2021,7,8,체육대회,지출,2017,487748
2022,9,27,여행,수입,8930,496678
2023,3,15,MT,수입,8783,505461
2021,6,11,쇼핑,지출,2406,503055
2022,11,25,여행,수입,7300,510355
2020,12,31,쇼핑,수입,6558,516913
2020,7,13,체육대회,지출,8756,508157
2023,7,7,MT,수입,6661,514818
2023,9,24,여행,수입,6959,521777
2023,5,24,식사,수입,5268,527045
2022,6,16,MT,지출,7747,519298
2022,2,20,체육대회,수입,8818,528116
2020,11,4,식사,지출,9890,518226
2021,7,2,MT,수입,4004,522230
2023,2,6,식사,지출,7491,514739
2023,5,4,쇼핑,수입,7283,522022
2023,1,27,식사,지출,5945,516077
2023,8,15,쇼핑,지출,3905,512172
2021,2,9,쇼핑,수입,7569,519741
2021,7,6,MT,지출,7192,512549
2020,11,11,체육대회,지출,2343,510206
2022,10,2,여행,지출,9806,500400
2021,1,19,여행,수입,6275,506675
2022,5,2,식사,수입,2572,509247
2022,7,23,여행,지출,3518,505729
2021,3,22,여행,지출,3353,502376
2022,1,29,쇼핑,수입,5220,507596
2022,9,16,여행,수입,6166,513762
2023,11,22,쇼핑,수입,6882,520644
2023,5,4,쇼핑,수입,9790,530434
2020,2,11,쇼핑,지출,3712,526722
2022,3,6,체육대회,지출,8293,518429
2021,6,23,여행,지출,1036,517393
2022,3,23,체육대회,수입,3915,521308
2022,11,28,체육대회,수입,4854,526162
2021,7,3,체육대회,수입,4335,530497
2021,3,8,식사,수입,8745,539242
2023,3,28,식사,수입,3952,543194
2022,8,11,식사,수입,2960,546154
2022,8,8,MT,수입,3934,550088
2020,3,9,여행,수입,9551,559639
2023,1,5,여행,수입,5499,565138
2020,3,15,체육대회,수입,6820,571958
2021,12,17,MT,지출,2328,569630
2022,7,24,쇼핑,수입,6824,576454
2021,4,26,쇼핑,지출,5861,570593
2022,11,6,식사,수입,5616,576209
2021,9,13,MT,수입,1740,577949
2020,11,18,여행,지출,2016,575933
2021,11,18,MT,지출,9518,566415
2022,7,28,쇼핑,수입,7108,573523
2023,5,12,여행,지출,7256,566267
2022,8,14,여행,수입,8415,574682
2022,8,9,MT,지출,6064,568618
2023,7,19,쇼핑,지출,4772,563846
2020,7,7,여행,수입,6813,570659
2021,9,22,식사,수입,6064,576723
2022,12,9,식사,지출,9733,566990
2021,7,2,쇼핑,지출,2199,564791
2022,12,6,쇼핑,지출,9423,555368
2022,11,10,쇼핑,수입,5202,560570
2020,7,26,체육대회,수입,3424,563994
2022,4,25,체육대회,수입,9247,573241
2020,7,21,여행,수입,1250,574491
2022,10,4,체육대회,지출,4762,569729
2023,12,24,체육대회,지출,1363,568366
2023,12,20,여행,수입,2717,571083
2020,10,16,체육대회,수입,7522,578605
2023,8,11,식사,지출,1610,576995
2023,9,9,쇼핑,지출,1284,575711
2020,6,20,여행,지출,3946,571765
2023,11,27,체육대회,지출,4460,567305
2020,12,28,체육대회,수입,8152,575457
2022,12,3,식사,지출,9912,565545
2020,12,19,체육대회,수입,5497,571042
2022,11,5,식사,수입,5688,576730
2021,4,14,쇼핑,수입,4642,581372
2022,8,30,쇼핑,수입,1670,583042
2020,1,24,MT,지출,5378,577664
2023,1,13,여행,지출,6834,570830
2021,1,12,식사,지출,5640,565190
2020,1,7,체육대회,수입,6328,571518
2021,1,12,MT,수입,3993,575511
2020,7,22,여행,수입,5184,580695
2021,6,22,MT,수입,8183,588878
2020,8,31,체육대회,수입,6748,595626
2023,5,21,체육대회,수입,2796,598422
2020,1,3,MT,수입,7329,605751
2021,1,5,쇼핑,지출,6135,599616
2020,12,22,체육대회,지출,1445,598171
2022,4,10,체육대회,지출,2591,595580
2020,10,23,MT,수입,1398,596978
2020,3,2,여행,수입,2704,599682
2021,10,7,식사,수입,4537,604219
2023,1,5,식사,수입,1157,605376
2020,3,1,식사,지출,2396,602980
2023,2,27,여행,수입,2192,605172
2023,2,20,쇼핑,수입,6828,612000
2023,7,23,MT,지출,6073,605927
2020,3,15,쇼핑,수입,3477,609404
2023,5,29,식사,지출,6510,602894
2020,1,25,체육대회,수입,2288,605182
2022,11,27,여행,지출,5025,600157
2023,8,10,식사,수입,9053,609210
2022,11,21,식사,지출,8972,600238
2021,5,28,MT,수입,4805,605043
2021,12,15,MT,지출,4251,600792
2023,1,30,여행,지출,2046,598746
2023,5,7,여행,지출,4558,594188
2022,1,22,쇼핑,지출,9672,584516
2020,6,19,여행,지출,8779,575737
2021,11,19,여행,지출,9598,566139
2022,10,22,여행,수입,4452,570591
2022,5,15,여행,지출,9837,560754
2020,6,22,식사,지출,7111,553643
2020,12,20,식사,수입,7538,561181
2021,11,3,쇼핑,수입,4299,565480
2021,12,9,여행,지출,4508,560972
2023,4,19,식사,지출,9709,551263
2023,4,27,식사,지출,4445,546818
2022,3,27,체육대회,지출,9509,537309
2023,1,3,MT,수입,4631,541940
2022,9,22,여행,지출,4682,537258
2020,4,27,체육대회,지출,1790,535468
2020,7,23,쇼핑,수입,3678,539146
2022,10,30,MT,지출,8134,531012
2023,10,15,쇼핑,수입,9683,540695
2023,10,3,여행,지출,2367,538328
2021,1,10,쇼핑,지출,3418,534910
2020,11,24,식사,지출,7053,527857
2023,1,14,여행,지출,3028,524829
2020,8,17,식사,수입,4770,529599
2020,5,21,쇼핑,지출,3863,525736
2020,1,7,쇼핑,수입,6943,532679
2022,5,20,여행,지출,2635,530044
2023,3,24,쇼핑,지출,8914,521130
2020,5,28,쇼핑,수입,3305,524435
2020,9,21,체육대회,지출,5230,519205
2021,2,2,쇼핑,지출,6065,513140
2020,4,18,여행,지출,4372,508768
2022,12,26,식사,지출,9898,498870
2021,2,8,쇼핑,지출,8696,490174
2020,9,17,여행,지출,6279,483895
2020,10,7,쇼핑,수입,3689,487584
2023,8,25,식사,지출,8053,479531
2021,11,17,쇼핑,지출,4762,474769
2021,2,21,체육대회,지출,3401,471368
2020,1,4,식사,수입,7199,478567
2022,5,22,체육대회,지출,2823,475744
2022,3,29,체육대회,수입,6316,482060
2020,10,21,식사,수입,3823,485883
2022,12,28,여행,수입,7342,493225
2023,1,2,식사,지출,8317,484908
2022,6,8,체육대회,수입,1010,485918
2023,5,14,MT,수입,1852,487770
2021,4,21,쇼핑,지출,6250,481520
2021,5,26,MT,지출,4243,477277
2022,1,31,여행,수입,1222,478499
2023,7,19,쇼핑,수입,1801,480300
2023,9,6,체육대회,지출,2889,477411
2022,5,13,식사,수입,2456,479867
2021,2,18,쇼핑,지출,1811,478056
2021,11,14,MT,지출,3488,474568
2022,11,2,쇼핑,지출,3019,471549
2023,11,2,MT,수입,2761,474310
2023,2,23,MT,수입,1125,475435
2022,5,26,식사,지출,6661,468774
2021,5,22,쇼핑,수입,3253,472027
2023,9,24,여행,수입,6170,478197
2021,6,7,체육대회,수입,1559,479756
2020,2,9,체육대회,수입,7079,486835
2021,8,28,식사,수입,4836,491671
2020,5,31,체육대회,수입,5808,497479
2021,6,24,여행,지출,5954,491525
2021,5,2,체육대회,지출,9529,481996
2022,12,24,쇼핑,수입,6827,488823
2022,7,13,체육대회,수입,2815,491638
2021,9,25,식사,수입,6110,497748
2022,9,18,체육대회,지출,8658,489090
2021,10,17,체육대회,수입,8503,497593
2023,11,21,쇼핑,수입,7323,504916
2022,3,2,체육대회,지출,9201,495715
2020,3,12,체육대회,지출,8439,487276
2021,4,8,체육대회,수입,7153,494429
2021,3,4,여행,수입,5518,499947
2021,6,25,체육대회,수입,6116,506063
2022,11,17,MT,수입,5100,511163
2022,8,1,쇼핑,지출,4736,506427
2023,6,16,식사,지출,1302,505125
2020,4,2,쇼핑,지출,3531,501594
2022,5,3,여행,지출,2085,499509
2023,10,31,여행,수입,7112,506621
2022,4,4,식사,수입,3437,510058
2020,11,25,체육대회,수입,9689,519747
2022,12,21,MT,수입,4901,524648
2020,7,21,체육대회,수입,2957,527605
2023,8,10,쇼핑,수입,6368,533973
2021,4,5,체육대회,수입,9482,543455
2023,7,18,여행,수입,3492,546947
2020,1,27,식사,지출,4513,542434
2020,10,2,쇼핑,지출,5730,536704
2021,9,7,여행,수입,7095,543799
2022,6,5,여행,지출,3467,540332
2022,8,9,체육대회,수입,5729,546061
2023,2,24,식사,지출,4768,541293
2023,6,14,MT,지출,7544,533749
2020,7,24,체육대회,수입,2080,535829
2020,11,16,쇼핑,지출,7480,528349
2022,9,13,여행,수입,1386,529735
2022,11,8,체육대회,지출,7758,521977
2023,11,7,쇼핑,수입,3279,525256
2023,6,4,MT,수입,2709,527965
2020,6,28,체육대회,지출,7882,520083
2021,8,8,여행,수입,2493,522576
2023,4,16,체육대회,수입,4880,527456
2023,11,4,여행,지출,6130,521326
2022,1,7,식사,지출,9183,512143
2023,7,16,체육대회,지출,7407,504736
2020,11,5,여행,지출,4758,499978
2022,5,6,쇼핑,지출,1656,498322
2020,6,26,여행,지출,1156,497166
2023,5,17,식사,지출,1404,495762
2021,5,30,여행,수입,6989,502751
2020,9,29,여행,지출,7508,495243
2022,3,17,식사,수입,4708,499951
2023,2,10,MT,지출,4278,495673
2020,3,12,체육대회,지출,1073,494600
2021,3,14,MT,지출,8322,486278
2020,5,27,여행,수입,4767,491045
2023,11,27,MT,지출,1392,489653
2020,5,9,여행,수입,9572,499225
2022,7,15,MT,수입,4929,504154
2021,8,3,식사,지출,7490,496664
2020,1,23,쇼핑,지출,1462,495202
2020,12,2,체육대회,지출,5391,489811
2020,2,26,체육대회,수입,2051,491862
2021,1,16,식사,수입,5468,497330
2022,3,19,여행,지출,4783,492547
2020,8,23,체육대회,지출,4317,488230
2023,11,20,체육대회,수입,6366,494596
2023,7,29,쇼핑,지출,4432,490164
2020,9,10,쇼핑,수입,1190,491354
2023,11,26,체육대회,수입,7965,499319
2022,4,24,MT,지출,2835,496484
2020,10,21,쇼핑,지출,6826,489658
2021,5,25,체육대회,지출,2052,487606
2020,8,3,체육대회,수입,6320,493926
2023,4,15,MT,수입,5470,499396
2020,6,27,식사,지출,3213,496183
2021,8,21,식사,수입,3146,499329
2020,11,11,식사,수입,2772,502101
2022,9,23,체육대회,수입,9181,511282
2020,10,26,식사,수입,7001,518283
2021,10,2,식사,수입,9881,528164
2020,10,31,식사,지출,6207,521957
2020,6,26,식사,지출,9162,512795
2023,10,19,식사,수입,7052,519847
2023,7,5,여행,수입,1269,521116
2022,10,29,식사,수입,9548,530664
2020,8,26,쇼핑,지출,8681,521983
2023,9,13,체육대회,수입,2532,524515
2022,1,22,쇼핑,수입,7711,532226
2021,4,1,MT,수입,9723,541949
2023,4,21,쇼핑,지출,9961,531988
2023,6,13,식사,수입,4672,536660
2023,1,17,여행,수입,1569,538229
2023,9,21,MT,수입,5938,544167
2022,9,26,체육대회,수입,8378,552545
2023,4,1,MT,지출,2531,550014
2022,1,8,여행,수입,5220,555234
2020,12,10,여행,수입,9941,565175
2023,9,28,MT,수입,2358,567533
2021,8,25,쇼핑,수입,9605,577138
2021,3,31,쇼핑,수입,3265,580403
2021,11,26,MT,지출,9143,571260
2023,12,1,여행,수입,4066,575326
2023,11,13,체육대회,지출,4623,570703
2023,1,15,여행,수입,4966,575669
2023,8,21,MT,지출,8524,567145
2022,3,11,여행,지출,1392,565753
2021,1,14,여행,수입,3301,569054
2022,4,26,여행,지출,2187,566867
2023,2,2,MT,지출,8969,557898
2022,6,24,식사,지출,6342,551556
2020,1,4,체육대회,지출,3230,548326
2020,12,14,여행,지출,3256,545070
2020,11,12,체육대회,지출,1163,543907
2021,2,19,쇼핑,지출,3233,540674
2020,3,24,식사,수입,9847,550521
2021,5,30,MT,지출,7234,543287
2020,12,10,식사,수입,3946,547233
2023,8,20,쇼핑,지출,1790,545443
2021,9,15,식사,지출,3011,542432
2020,4,4,MT,지출,7138,535294
2020,5,12,여행,지출,9485,525809
2020,7,7,쇼핑,수입,5504,531313
2020,6,25,식사,지출,4371,526942
2022,6,1,체육대회,수입,4819,531761
2020,2,20,식사,지출,2452,529309
2021,1,17,여행,지출,5421,523888
2023,10,30,여행,지출,8023,515865
2022,8,3,쇼핑,지출,9968,505897
2020,3,19,식사,지출,7163,498734
2022,1,6,쇼핑,수입,6782,505516
2022,3,23,MT,수입,3817,509333
2020,12,10,MT,수입,5608,514941
2023,11,1,체육대회,지출,7776,507165
2021,9,16,MT,수입,4688,511853
2020,11,15,체육대회,수입,4720,516573
2020,9,16,MT,수입,5360,521933
2020,4,17,체육대회,수입,3302,525235
2022,2,27,쇼핑,수입,7644,532879
2020,2,8,식사,수입,5508,538387
2020,11,4,MT,수입,1617,540004
2020,12,16,쇼핑,지출,6938,533066
2021,7,11,식사,수입,9843,542909
2022,11,26,여행,수입,1923,544832
2021,5,30,체육대회,지출,5382,539450
2021,10,29,쇼핑,지출,2030,537420
2022,1,29,식사,지출,2497,534923
2020,1,20,체육대회,수입,3885,538808
2021,12,18,식사,수입,5277,544085
2022,11,10,쇼핑,수입,6462,550547
2023,10,26,여행,지출,1226,549321
2021,4,10,식사,수입,3391,552712
2020,6,16,쇼핑,수입,1453,554165
2022,7,24,MT,지출,4623,549542
2023,12,19,MT,지출,8154,541388
2020,2,25,여행,지출,1324,540064
2023,11,25,식사,수입,3276,543340
2023,2,28,식사,지출,7686,535654
2021,10,13,여행,수입,5845,541499
2020,10,23,식사,수입,5442,546941
2023,1,7,여행,수입,2253,549194
2020,5,2,여행,지출,5457,543737
2022,12,8,쇼핑,수입,1636,545373
2020,12,2,식사,지출,9112,536261
2021,3,9,여행,수입,4586,540847
2023,9,26,MT,지출,1292,539555
2021,10,31,쇼핑,수입,1104,540659
2021,10,9,체육대회,수입,3720,544379
2020,3,26,MT,지출,9180,535199
2023,7,21,식사,지출,5661,529538
2020,10,30,MT,수입,1057,530595
2023,3,3,체육대회,수입,2851,533446
2023,9,24,여행,수입,8371,541817
2021,2,3,식사,지출,3433,538384
2022,4,15,여행,지출,5630,532754
2020,1,16,식사,지출,4807,527947
2020,1,1,MT,지출,5955,521992
2021,2,20,여행,수입,4666,526658
2020,11,20,MT,지출,6938,519720
2023,4,18,식사,지출,7373,512347
2020,10,6,MT,지출,1192,511155
2021,1,21,여행,지출,8411,502744
2023,4,14,쇼핑,수입,5436,508180
2020,10,12,체육대회,수입,1366,509546
2021,2,23,여행,지출,6216,503330
2022,4,21,MT,지출,8820,494510
2021,11,7,쇼핑,수입,9934,504444
2021,11,9,여행,수입,9446,513890
2022,6,4,쇼핑,지출,7960,505930
2020,3,6,여행,수입,6676,512606
2021,9,1,체육대회,수입,5400,518006
2022,1,2,쇼핑,수입,4525,522531
2021,9,6,식사,수입,4199,526730
2020,11,1,여행,수입,4589,531319
2022,8,29,쇼핑,수입,3379,534698
2020,11,11,식사,수입,5797,540495
2021,4,25,체육대회,수입,1119,541614
2021,11,30,MT,지출,1297,540317
2022,12,28,MT,수입,1716,542033
2021,5,15,여행,수입,4878,546911
2022,2,24,여행,지출,2052,544859
2023,4,26,여행,지출,1223,543636
2022,1,24,체육대회,수입,7789,551425
2022,12,21,체육대회,지출,2901,548524
2022,12,18,식사,지출,1538,546986
2022,4,20,식사,지출,3035,543951
2021,6,15,여행,지출,8120,535831
2023,5,2,여행,지출,7835,527996
2020,12,20,여행,지출,1287,526709
2020,2,10,여행,지출,6827,519882
2022,1,23,여행,지출,1373,518509
2023,6,14,식사,지출,5623,512886
2020,2,3,MT,수입,7018,519904
2022,12,27,여행,수입,2287,522191
2022,3,6,쇼핑,지출,1422,520769
2020,7,19,여행,수입,5793,526562
2023,2,18,체육대회,지출,3931,522631
2023,6,4,MT,수입,8142,530773
2023,8,5,체육대회,지출,7764,523009
2020,4,3,쇼핑,지출,1362,521647
2022,4,29,쇼핑,지출,8696,512951
2021,8,16,체육대회,지출,9486,503465
2023,2,2,여행,지출,9233,494232
2020,9,22,여행,지출,4267,489965
2021,2,12,체육대회,수입,5739,495704
2022,6,15,MT,수입,6499,502203
2023,3,10,체육대회,지출,4684,497519
2021,5,1,식사,수입,6012,503531
2022,5,10,쇼핑,수입,6346,509877
2020,4,22,MT,수입,6188,516065
2021,9,13,쇼핑,수입,3032,519097
2022,11,27,체육대회,지출,7140,511957
2020,8,28,MT,지출,5491,506466
2022,10,13,여행,수입,9377,515843
2020,7,18,쇼핑,지출,5684,510159
2021,3,11,쇼핑,수입,5291,515450
2020,4,4,쇼핑,지출,3575,511875
2022,2,6,식사,지출,7448,504427
2022,2,15,쇼핑,지출,9027,495400
2021,9,22,체육대회,수입,5952,501352
2023,10,6,체육대회,수입,5502,506854
2022,11,12,식사,수입,8128,514982
2022,3,7,MT,지출,2299,512683
2023,6,7,식사,지출,2972,509711
2020,11,13,체육대회,수입,2247,511958
2023,6,24,여행,지출,3199,508759
2020,7,6,체육대회,지출,4682,504077
2023,9,2,여행,지출,2408,501669
2023,1,3,여행,수입,6250,507919
2022,9,28,MT,수입,4959,512878
2021,8,13,MT,수입,5323,518201
2022,7,10,체육대회,수입,7253,525454
2020,1,19,여행,지출,1174,524280
2020,10,13,체육대회,수입,6956,531236
2020,6,9,식사,지출,7507,523729
2022,1,4,쇼핑,지출,1221,522508
2020,3,12,쇼핑,수입,8831,531339
2022,2,5,쇼핑,지출,2215,529124
2022,6,30,여행,수입,2708,531832
2023,3,23,체육대회,수입,1725,533557
2021,3,2,체육대회,지출,4679,528878
2023,11,8,MT,지출,9661,519217
2022,2,21,MT,지출,7887,511330
2021,11,14,식사,수입,5755,517085
2022,3,25,여행,지출,5562,511523
2021,4,16,쇼핑,수입,9389,520912
2023,11,18,여행,지출,8112,512800
2023,1,6,MT,수입,6377,519177
2020,5,26,식사,수입,3099,522276
2023,8,8,MT,지출,6706,515570
2020,10,3,MT,지출,9824,505746
2020,11,7,MT,수입,2272,508018
2023,10,6,쇼핑,지출,4471,503547
2020,3,18,MT,지출,3382,500165
2023,7,18,식사,수입,2432,502597
2020,4,10,쇼핑,지출,4409,498188
2021,3,19,식사,수입,7038,505226
2022,9,18,식사,수입,3863,509089
2023,1,31,식사,수입,3559,512648
2022,2,11,여행,수입,7944,520592
2020,11,15,식사,수입,7268,527860
2023,1,5,쇼핑,지출,5044,522816
2023,6,9,여행,수입,5456,528272
2021,10,24,여행,지출,3013,525259
2022,4,1,여행,수입,4689,529948
2023,4,22,체육대회,지출,2972,526976
2023,1,17,여행,수입,3969,530945
2021,10,26,쇼핑,수입,9158,540103
2021,10,27,식사,수입,9302,549405
2021,6,11,MT,지출,5348,544057
2021,9,21,체육대회,수입,4814,548871
2023,8,18,식사,수입,5021,553892
2021,4,15,식사,지출,7141,546751
2021,7,15,여행,수입,9605,556356
2023,10,11,식사,지출,7374,548982
2022,7,4,쇼핑,수입,8946,557928
2020,5,20,여행,지출,6499,551429
2022,7,6,식사,지출,8764,542665
2020,1,14,체육대회,수입,8472,551137
2021,6,28,체육대회,수입,3781,554918
2023,5,22,체육대회,지출,7266,547652
2022,4,22,체육대회,지출,9435,538217
2023,6,27,쇼핑,수입,7230,545447
2021,10,10,식사,수입,2325,547772
2023,9,30,식사,지출,8352,539420
2022,3,28,식사,수입,7708,547128
2020,1,7,식사,지출,4658,542470
2023,2,28,여행,지출,8949,533521
2020,6,23,여행,수입,9358,542879
2020,10,6,MT,지출,5083,537796
2020,4,11,쇼핑,지출,4205,533591
2022,8,27,식사,지출,4591,529000
2020,10,31,쇼핑,수입,3826,532826
2021,3,29,체육대회,수입,6678,539504
2022,12,21,체육대회,지출,9987,529517
2023,3,7,식사,수입,2247,531764
2023,4,10,쇼핑,수입,9335,541099
2022,9,26,MT,지출,6118,534981
2023,7,26,여행,수입,2076,537057
2022,5,21,MT,지출,5090,531967
2022,5,15,MT,수입,7427,539394
2022,1,25,쇼핑,지출,3850,535544
2021,3,17,쇼핑,지출,8094,527450
2023,1,20,쇼핑,수입,8329,535779
2022,12,24,여행,수입,2994,538773
2023,1,29,여행,지출,8118,530655
2023,8,29,MT,지출,3416,527239
2020,3,10,여행,지출,6998,520241
2021,10,23,쇼핑,수입,4106,524347
2022,8,15,여행,지출,9759,514588
2023,11,2,여행,수입,7656,522244
2022,4,20,체육대회,지출,8056,514188
2021,4,19,여행,지출,7921,506267
2021,8,2,체육대회,지출,2683,503584
2023,1,15,여행,수입,9416,513000
2021,10,20,여행,수입,8389,521389
2021,3,9,MT,지출,9060,512329
2022,2,11,MT,지출,1687,510642
2020,7,31,쇼핑,수입,7869,518511
2022,6,4,체육대회,수입,1196,519707
2020,6,25,식사,수입,2654,522361
2020,4,11,MT,수입,1811,524172
2021,7,22,체육대회,지출,7592,516580
2020,1,15,체육대회,수입,1627,518207
2021,12,7,MT,지출,9875,508332
2021,3,21,MT,수입,9652,517984
2020,2,20,여행,수입,6246,524230
2022,3,15,쇼핑,수입,3725,527955
2020,10,19,MT,지출,3031,524924
2021,7,22,쇼핑,수입,1036,525960
2022,6,9,체육대회,수입,7471,533431
2022,1,27,식사,지출,8623,524808
2022,4,8,여행,지출,3105,521703
2021,6,18,MT,지출,6010,515693
2021,11,22,MT,지출,9398,506295
2021,2,3,쇼핑,수입,3121,509416
2020,5,8,체육대회,수입,5824,515240
2020,11,27,식사,지출,9024,506216
2021,4,17,쇼핑,수입,7524,513740
2021,5,15,여행,수입,3372,517112
2021,2,9,식사,지출,6650,510462
2023,11,12,식사,수입,5485,515947
2023,9,9,MT,수입,5670,521617
2020,12,22,쇼핑,수입,2537,524154
2022,7,5,쇼핑,지출,3190,520964
2023,9,20,식사,수입,9642,530606
2020,4,2,여행,수입,8768,539374
2022,4,13,체육대회,수입,5484,544858
2020,5,9,쇼핑,지출,8902,535956
2021,2,16,쇼핑,수입,4867,540823
2022,3,29,여행,지출,4755,536068
2021,6,23,식사,수입,1179,537247
2023,11,9,쇼핑,지출,4472,532775
2021,12,31,MT,수입,4836,537611
2021,11,13,쇼핑,수입,1519,539130
2021,8,29,MT,지출,6029,533101
2022,4,12,식사,수입,3816,536917
2021,6,3,여행,지출,5589,531328
2021,10,29,체육대회,지출,6914,524414
2022,2,15,체육대회,수입,9742,534156
2023,11,4,쇼핑,지출,4111,530045
2023,3,1,여행,지출,2449,527596
2023,7,10,쇼핑,수입,3801,531397
2022,11,14,쇼핑,수입,2395,533792
2022,5,18,여행,수입,8214,542006
2020,3,1,식사,수입,3514,545520
2022,11,1,체육대회,수입,8982,554502
2022,4,5,식사,수입,4781,559283
2020,1,3,체육대회,지출,4821,554462
2023,9,4,체육대회,수입,5526,559988
2023,10,16,식사,수입,5802,565790
2022,6,22,체육대회,지출,2410,563380
2022,11,21,MT,지출,9600,553780
2020,8,30,쇼핑,수입,3033,556813
2021,4,29,MT,수입,3234,560047
2020,6,24,식사,수입,4094,564141
2022,10,16,쇼핑,지출,9259,554882
2021,1,25,여행,수입,8036,562918
2021,6,26,MT,수입,5515,568433
2022,7,2,여행,지출,3133,565300
2022,1,4,쇼핑,수입,6736,572036
2022,5,26,여행,수입,6315,578351
2023,5,5,체육대회,수입,9755,588106
2022,7,29,체육대회,지출,3150,584956
2023,1,6,식사,지출,8182,576774
2021,5,28,여행,지출,1620,575154
2022,11,20,MT,지출,9215,565939
2021,7,8,체육대회,지출,7527,558412
2023,1,13,식사,수입,6375,564787
2020,10,29,체육대회,지출,9421,555366
2023,11,29,여행,지출,6508,548858
2023,10,3,쇼핑,지출,3695,545163
2020,7,2,쇼핑,수입,9979,555142
2023,3,28,MT,지출,9361,545781
2021,8,24,MT,수입,9384,555165
2023,10,17,체육대회,수입,4992,560157
2020,5,8,식사,수입,1689,561846
2021,10,15,쇼핑,수입,3776,565622
2021,4,27,MT,수입,8168,573790
2021,12,20,여행,수입,9987,583777
2020,2,16,체육대회,지출,3858,579919
2021,4,28,쇼핑,수입,9235,589154
2022,12,13,여행,지출,7964,581190
2020,11,12,여행,지출,1973,579217
2020,6,15,체육대회,지출,2512,576705
2021,8,11,체육대회,지출,3061,573644
2020,5,24,쇼핑,지출,4298,569346
2021,11,24,식사,지출,8155,561191
2021,7,9,식사,수입,5569,566760
2021,3,2,체육대회,지출,6616,560144
2020,4,15,쇼핑,수입,6192,566336
2021,10,16,체육대회,지출,2268,564068
2022,5,12,MT,지출,2643,561425
2023,9,7,MT,지출,1918,559507
2021,7,12,쇼핑,수입,2441,561948
2021,12,31,쇼핑,지출,8840,553108
2020,6,25,체육대회,지출,9994,543114
2020,9,19,여행,지출,2404,540710
2021,10,20,여행,지출,1205,539505
2021,3,29,식사,지출,9302,530203
2022,1,13,체육대회,수입,4263,534466
2020,6,21,여행,지출,3412,531054
2020,9,12,MT,지출,2021,529033
2022,3,24,여행,수입,7176,536209
2022,8,13,체육대회,지출,4692,531517
2022,5,13,식사,수입,5101,536618
2021,11,1,식사,수입,7200,543818
2020,7,12,식사,지출,1143,542675
2021,7,28,쇼핑,수입,2092,544767
2023,3,16,쇼핑,지출,2991,541776
2021,7,23,MT,지출,7933,533843
2021,6,9,식사,수입,5491,539334
2023,9,8,MT,지출,4534,534800
2023,6,18,쇼핑,지출,2230,532570
2023,7,20,MT,수입,9525,542095
2021,2,23,쇼핑,지출,4459,537636
2023,5,2,여행,지출,7187,530449
2021,9,27,여행,지출,9989,520460
2020,12,31,여행,수입,9507,529967
2022,2,6,체육대회,수입,6571,536538
2022,8,12,여행,수입,7466,544004
2022,10,28,MT,수입,2432,546436
2022,11,19,식사,수입,1579,548015
2023,1,20,여행,지출,5078,542937
2021,3,25,식사,수입,9070,552007
2021,7,31,식사,수입,3957,555964
2023,6,19,식사,지출,2403,553561
2023,12,25,체육대회,지출,6510,547051
2020,11,9,식사,지출,1263,545788
2023,10,16,쇼핑,지출,2798,542990
2021,7,4,체육대회,지출,3017,539973
2021,4,26,식사,지출,3645,536328
2023,7,13,쇼핑,지출,1273,535055
2021,11,22,MT,지출,4734,530321
2022,3,12,체육대회,지출,9109,521212
2021,10,16,여행,수입,5340,526552
2023,6,23,식사,수입,4956,531508
2022,4,16,MT,지출,8252,523256
2022,2,23,여행,지출,8416,514840
2021,8,23,MT,수입,6811,521651
2021,1,19,MT,지출,3190,518461
2021,9,16,체육대회,수입,1323,519784
2020,10,14,쇼핑,지출,8064,511720
2022,2,28,MT,지출,5285,506435
2020,4,19,쇼핑,수입,1291,507726
2022,10,20,쇼핑,지출,1643,506083
2023,11,23,식사,지출,5702,500381
2020,4,2,체육대회,수입,1573,501954
2023,6,18,쇼핑,수입,2993,504947
2021,3,28,여행,지출,7648,497299
2023,1,7,체육대회,수입,9234,506533
2020,4,20,체육대회,수입,3595,510128
2022,9,12,여행,수입,9770,519898
2020,9,24,MT,지출,7341,512557
2023,10,10,MT,지출,9473,503084
2023,7,26,체육대회,지출,2499,500585
2020,12,30,MT,지출,7290,493295
2022,1,13,쇼핑,지출,2004,491291
2022,1,11,체육대회,수입,2110,493401
2021,2,22,MT,수입,5846,499247
2023,8,18,식사,수입,7323,506570
2020,4,18,MT,지출,1094,505476
2023,12,2,체육대회,수입,6206,511682
2020,4,6,MT,수입,7929,519611
2020,11,19,MT,지출,1292,518319
2023,11,13,체육대회,수입,2625,520944
2023,4,24,체육대회,수입,2512,523456
2022,12,12,체육대회,수입,1573,525029
2020,2,18,MT,지출,4622,520407
2022,9,11,체육대회,수입,8864,529271
2020,10,22,여행,수입,6904,536175
2020,9,5,쇼핑,지출,2071,534104
2020,10,23,쇼핑,지출,1280,532824
2023,5,18,쇼핑,수입,9116,541940
2021,9,24,체육대회,지출,9012,532928
2023,8,18,여행,지출,1537,531391
2020,10,8,체육대회,지출,1551,529840
2022,1,18,MT,수입,7183,537023
2020,12,23,여행,지출,7270,529753
2021,11,16,MT,수입,7025,536778
2022,7,16,MT,지출,8042,528736
2022,9,22,식사,지출,6539,522197
2023,3,18,쇼핑,지출,3729,518468
2020,3,12,식사,수입,8975,527443
2023,5,22,MT,수입,4987,532430
2021,1,11,체육대회,지출,5528,526902
2021,12,31,식사,지출,2539,524363
2021,11,10,식사,수입,3979,528342
2023,9,1,MT,지출,6320,522022
2023,3,29,식사,수입,5084,527106
2020,1,30,여행,지출,3448,523658
2023,7,12,쇼핑,지출,1705,521953
2021,6,27,MT,지출,3234,518719
2023,9,17,여행,수입,9407,528126
2022,2,23,MT,지출,7964,520162
2021,7,27,식사,수입,5910,526072
2023,2,13,체육대회,지출,9198,516874
2020,1,20,식사,지출,7833,509041
2021,1,11,MT,수입,2623,511664
2020,4,28,쇼핑,수입,4724,516388
2022,7,29,쇼핑,수입,2471,518859
2021,9,25,식사,지출,2771,516088
2023,5,10,여행,지출,1883,514205
2023,11,15,식사,지출,3726,510479
2023,6,19,체육대회,수입,1111,511590
2022,2,26,식사,수입,2912,514502
2021,9,24,여행,지출,7006,507496
2020,5,15,MT,지출,3068,504428
2023,12,16,체육대회,수입,9478,513906
2020,3,24,여행,수입,4279,518185
2023,2,3,체육대회,수입,9054,527239
2022,3,25,여행,수입,2446,529685
2023,1,22,여행,지출,5964,523721
2021,11,4,MT,수입,9148,532869
2020,3,23,MT,수입,3436,536305
2021,3,7,여행,수입,1394,537699
2022,6,7,MT,수입,3048,540747
2021,1,15,식사,지출,6560,534187
2021,1,12,체육대회,수입,4479,538666
2022,3,7,식사,지출,9113,529553
2021,5,3,여행,지출,3398,526155
2020,3,9,식사,지출,5191,520964
2022,3,12,여행,수입,8220,529184
2020,9,18,식사,지출,8643,520541
2023,4,18,식사,지출,3617,516924
2022,6,20,체육대회,지출,8980,507944
2020,7,19,쇼핑,수입,5730,513674
2022,10,16,여행,수입,8319,521993
2020,6,7,식사,지출,4988,517005
2020,6,17,체육대회,지출,2208,514797
2022,12,11,식사,지출,8827,505970
2023,12,27,체육대회,수입,7281,513251
2020,7,4,여행,수입,6512,519763
2022,9,9,식사,수입,9150,528913
2020,1,18,쇼핑,수입,9015,537928
2020,9,28,쇼핑,수입,4809,542737
2020,1,16,체육대회,수입,8253,550990
2020,5,30,식사,지출,9599,541391
2021,8,31,MT,지출,9259,532132
2023,1,7,쇼핑,지출,9331,522801
2020,2,8,쇼핑,지출,6507,516294
2022,6,30,체육대회,수입,6165,522459
2020,11,18,체육대회,수입,8701,531160
2020,6,15,식사,수입,4454,535614
2023,1,4,체육대회,수입,2365,537979
2022,10,16,여행,지출,2197,535782
2022,7,7,식사,지출,9115,526667
2020,1,27,체육대회,지출,2832,523835
2022,5,26,체육대회,수입,6650,530485
2023,8,5,쇼핑,지출,8513,521972
2022,1,1,체육대회,지출,6350,515622
2022,1,17,쇼핑,수입,2926,518548
2021,6,6,쇼핑,수입,5373,523921
2020,2,24,MT,지출,8487,515434
2022,8,31,쇼핑,수입,5966,521400
2020,8,21,체육대회,지출,9285,512115
2023,3,13,체육대회,수입,1475,513590
2022,1,10,MT,지출,2877,510713
2020,1,21,쇼핑,지출,6718,503995
2023,1,31,체육대회,수입,2197,506192
2022,9,29,MT,지출,2318,503874
2023,8,3,여행,수입,8115,511989
2023,7,3,체육대회,수입,6788,518777
2021,12,25,쇼핑,수입,8531,527308
2022,7,18,MT,지출,2323,524985
2022,4,4,식사,지출,5561,519424
2023,9,1,식사,수입,8440,527864
2021,1,1,쇼핑,지출,2602,525262
2021,3,7,여행,지출,4375,520887
2023,9,25,MT,지출,2169,518718
2020,7,15,쇼핑,수입,9518,528236
2022,1,20,체육대회,지출,9372,518864
2021,7,14,MT,수입,6822,525686
2023,4,22,쇼핑,수입,2944,528630
2023,2,6,쇼핑,지출,9968,518662
2023,2,9,쇼핑,수입,9422,528084
2020,7,30,쇼핑,지출,2710,525374
2020,2,12,쇼핑,수입,2731,528105
2022,8,22,식사,수입,5035,533140
2020,4,10,식사,수입,6566,539706
2021,11,4,MT,수입,3067,542773
2022,6,16,MT,수입,4423,547196
2023,4,21,체육대회,지출,2809,544387
2023,9,20,식사,수입,1457,545844
2020,2,25,쇼핑,지출,7717,538127
2023,8,28,식사,지출,4211,533916
2021,8,4,체육대회,지출,2976,530940
2021,3,18,체육대회,수입,3833,534773
2023,12,6,식사,지출,3982,530791
2023,8,8,MT,지출,8839,521952
2023,8,12,체육대회,수입,3526,525478
2023,1,1,쇼핑,지출,7830,517648
2020,12,19,식사,수입,5658,523306
2022,4,5,식사,지출,7454,515852
2021,8,7,MT,수입,4713,520565
2020,5,22,식사,지출,4368,516197
2023,8,29,여행,지출,3133,513064
2023,8,6,쇼핑,지출,1189,511875
2022,8,26,여행,지출,8705,503170
2020,9,1,쇼핑,수입,9672,512842
2023,10,18,여행,지출,4501,508341
2023,3,24,MT,지출,6426,501915
2020,9,28,체육대회,수입,5722,507637
2023,9,16,MT,지출,5391,502246
2022,3,17,쇼핑,지출,5840,496406
2022,12,18,여행,수입,9675,506081
2022,7,15,MT,지출,8239,497842
2020,1,10,식사,수입,5356,503198
2021,5,22,체육대회,지출,7603,495595
2021,4,11,MT,지출,2311,493284
2023,9,14,MT,지출,6965,486319
2023,1,22,체육대회,수입,3491,489810
2023,12,20,쇼핑,수입,7357,497167
2020,12,11,여행,지출,7593,489574
2021,2,14,체육대회,지출,3652,485922
2020,11,10,쇼핑,수입,3671,489593
2022,7,4,MT,수입,5709,495302
2020,6,2,체육대회,지출,4024,491278
2022,12,17,식사,수입,3420,494698
2020,3,13,MT,수입,7863,502561
2020,7,15,체육대회,수입,5982,508543
2022,6,21,쇼핑,수입,4136,512679
2021,12,10,식사,수입,9890,522569
2023,5,19,쇼핑,지출,9848,512721
2022,6,12,쇼핑,지출,4688,508033
2020,7,22,여행,지출,4479,503554
2021,2,20,MT,수입,9262,512816
2022,5,31,여행,수입,2692,515508
2022,2,1,쇼핑,지출,6953,508555
2020,10,29,쇼핑,지출,8259,500296
2023,10,31,체육대회,수입,2402,502698
2021,7,27,식사,지출,4526,498172
2020,1,11,쇼핑,수입,6751,504923
2022,7,13,식사,지출,2088,502835
2021,5,2,여행,수입,1928,504763
2020,2,21,여행,수입,7318,512081
2020,9,11,MT,수입,4317,516398
2023,1,3,식사,지출,5534,510864
2022,8,13,식사,지출,5156,505708
2023,11,22,체육대회,수입,4085,509793
2022,10,17,쇼핑,수입,7194,516987
2021,3,25,MT,수입,9131,526118
2023,2,23,여행,수입,3529,529647
2020,8,13,MT,수입,4817,534464
2021,9,22,체육대회,지출,1218,533246
2021,7,2,쇼핑,수입,6131,539377
2020,7,30,식사,수입,4487,543864
2020,3,31,쇼핑,지출,8476,535388
2023,8,26,식사,지출,3986,531402
2020,11,8,체육대회,수입,4048,535450
2020,4,5,체육대회,지출,5332,530118
2022,10,1,체육대회,지출,7700,522418
2020,4,3,MT,지출,3205,519213
2021,2,11,쇼핑,지출,5277,513936
2020,1,8,여행,수입,6939,520875
2021,8,15,식사,수입,8091,528966
2020,7,25,체육대회,수입,7047,536013
2020,7,16,쇼핑,지출,5789,530224
2022,7,7,쇼핑,지출,2498,527726
2021,5,9,여행,수입,2241,529967
2022,2,9,체육대회,지출,1278,528689
2020,9,14,쇼핑,수입,4473,533162
2021,5,22,MT,지출,8690,524472
2020,10,26,쇼핑,지출,9631,514841
2021,2,3,여행,수입,1004,515845
2022,1,21,MT,지출,5370,510475
2021,2,16,체육대회,수입,2284,512759
2023,12,31,체육대회,지출,2860,509899
2020,10,24,여행,지출,7722,502177
2023,3,13,쇼핑,수입,4386,506563
2020,9,7,식사,지출,2984,503579
2023,4,20,여행,수입,1404,504983
2020,1,24,쇼핑,지출,9497,495486
2021,10,2,여행,수입,7902,503388
2022,9,16,여행,수입,3990,507378
2020,2,4,MT,수입,2434,509812
2023,2,6,체육대회,지출,7612,502200
2021,3,21,식사,지출,8326,493874
2020,5,23,식사,지출,1655,492219
2023,11,14,쇼핑,수입,5513,497732
2021,11,17,여행,지출,6926,490806
2022,5,9,쇼핑,지출,4528,486278
2021,6,9,식사,수입,2981,489259
2022,4,22,체육대회,지출,8359,480900
2023,6,9,체육대회,지출,4305,476595
2021,5,1,여행,수입,5944,482539
2022,7,13,체육대회,지출,6915,475624
2022,1,18,식사,수입,9991,485615
2020,1,29,쇼핑,수입,8119,493734
2021,2,19,여행,지출,5483,488251
2021,3,7,MT,지출,1769,486482
2021,11,13,쇼핑,수입,3322,489804
2022,4,14,MT,수입,9750,499554
2022,2,15,쇼핑,지출,8143,491411
2023,7,26,쇼핑,수입,7714,499125
2020,10,27,여행,수입,1156,500281
2021,2,8,MT,지출,9992,490289
2020,7,7,여행,지출,5492,484797
2021,12,5,여행,수입,2321,487118
2020,5,28,MT,수입,3271,490389
2021,7,21,식사,지출,5887,484502
2020,12,8,여행,수입,4064,488566
2021,4,20,체육대회,지출,6064,482502
2021,7,8,여행,수입,2788,485290
2021,6,26,MT,수입,3349,488639
2022,8,10,쇼핑,지출,9763,478876
2022,8,8,식사,수입,7523,486399
2023,4,10,여행,수입,9667,496066
2021,11,21,식사,수입,7698,503764
2023,7,14,MT,수입,1745,505509
2020,4,15,쇼핑,지출,6885,498624
2020,10,8,체육대회,지출,7901,490723
2021,6,30,여행,지출,7748,482975
2022,7,4,체육대회,지출,3570,479405
2020,9,6,여행,수입,4869,484274
2021,9,29,식사,수입,6956,491230
2021,6,12,여행,지출,1539,489691
2020,2,16,체육대회,수입,1133,490824
2020,10,16,체육대회,지출,5013,485811
2022,2,1,쇼핑,수입,1601,487412
2020,2,12,여행,지출,1966,485446
2021,2,12,식사,지출,3506,481940
2020,4,12,MT,수입,5000,486940
2023,9,27,여행,수입,3045,489985
2020,12,25,식사,수입,1201,491186
2022,3,7,식사,수입,2513,493699
2021,9,5,쇼핑,수입,5702,499401
2023,10,8,쇼핑,수입,3690,503091
2021,9,26,식사,수입,9335,512426
2022,4,27,쇼핑,수입,9260,521686
2023,9,7,여행,지출,5975,515711
2020,2,21,쇼핑,수입,2961,518672
2020,1,31,쇼핑,수입,1460,520132
2020,10,26,식사,지출,5454,514678
2022,9,24,MT,지출,3590,511088
2020,7,29,체육대회,수입,5075,516163
2020,1,16,체육대회,지출,7195,508968
2022,10,16,쇼핑,수입,5639,514607
2023,11,25,식사,지출,9230,505377
2020,5,11,식사,지출,5117,500260
2023,11,1,MT,지출,6562,493698
2021,8,20,MT,지출,2828,490870
2020,4,17,체육대회,수입,5898,496768
2021,5,23,식사,수입,4267,501035
2022,10,12,쇼핑,지출,9581,491454
2022,7,12,체육대회,수입,1172,492626
2022,7,8,식사,지출,1398,491228
2022,7,6,식사,지출,5039,486189
2023,9,3,체육대회,수입,8892,495081
2022,11,26,MT,지출,8066,487015
2022,4,25,쇼핑,지출,6936,480079
2023,5,23,MT,지출,1761,478318
2020,12,29,MT,수입,7665,485983
2022,2,18,여행,지출,6650,479333
2022,7,22,MT,수입,2092,481425
2021,8,12,체육대회,수입,3718,485143
2021,12,10,MT,지출,7844,477299
2023,10,4,식사,지출,3148,474151
2023,8,7,여행,지출,3118,471033
2020,8,7,여행,지출,2004,469029
2020,2,8,MT,수입,8644,477673
2020,6,23,MT,지출,9419,468254
2021,12,24,체육대회,지출,5186,463068
2023,12,23,쇼핑,지출,2436,460632
2023,10,4,쇼핑,지출,2235,458397
2023,3,30,MT,지출,6303,452094
2022,4,23,쇼핑,지출,2927,449167
2023,7,25,여행,수입,9149,458316
2020,7,23,여행,수입,5161,463477
2023,11,9,여행,수입,1597,465074
2023,1,27,여행,수입,8389,473463
2020,1,16,체육대회,지출,4136,469327
2022,3,4,쇼핑,수입,9297,478624
2022,8,20,체육대회,수입,2177,480801
2022,12,23,체육대회,수입,5515,486316
2022,9,5,식사,수입,8754,495070
2023,3,6,식사,수입,7836,502906
2022,1,17,MT,지출,9622,493284
2022,3,19,체육대회,수입,1678,494962
2020,3,24,MT,수입,2525,497487
2020,8,23,쇼핑,지출,9443,488044
2020,7,6,MT,지출,4017,484027
2020,8,11,쇼핑,지출,4258,479769
2022,10,9,식사,지출,5772,473997
2022,2,23,체육대회,지출,6475,467522
2023,9,27,식사,지출,4743,462779
2023,8,7,여행,수입,8713,471492
2023,12,24,MT,지출,2248,469244
2023,9,3,여행,지출,3618,465626
2021,5,11,여행,수입,5298,470924
2022,10,11,쇼핑,지출,3434,467490
2021,6,12,식사,수입,9967,477457
2021,3,14,쇼핑,지출,2266,475191
2020,11,18,식사,수입,2051,477242
2021,2,23,식사,지출,2702,474540
2023,12,18,MT,수입,9021,483561
2021,11,22,쇼핑,지출,4201,479360
2021,12,20,식사,수입,4766,484126
2020,8,16,식사,수입,1254,485380
2022,1,28,체육대회,지출,3226,482154
2023,11,20,체육대회,지출,5948,476206
2023,7,15,여행,수입,7839,484045
2023,3,29,쇼핑,수입,9437,493482
2023,10,18,식사,수입,4682,498164
2021,1,12,MT,수입,2855,501019
2022,5,7,여행,수입,9793,510812
2021,4,4,식사,지출,6365,504447
2020,1,4,식사,수입,2300,506747
2022,4,30,MT,지출,2205,504542
2021,6,8,MT,지출,8645,495897
2022,2,14,식사,지출,7915,487982
2020,12,2,식사,지출,7592,480390
2022,5,11,여행,지출,7808,472582
2022,7,15,식사,지출,9171,463411
2021,1,27,식사,수입,2968,466379
2020,6,14,체육대회,수입,4967,471346
2022,12,21,MT,지출,3792,467554
2020,4,24,MT,수입,1707,469261
2020,9,21,식사,지출,6040,463221
2020,3,10,쇼핑,지출,3751,459470
2021,9,12,식사,지출,5756,453714
2023,11,11,쇼핑,수입,1835,455549
2020,5,19,MT,수입,9265,464814
2023,2,11,쇼핑,지출,7748,457066
2022,12,23,체육대회,지출,4006,453060
2022,4,29,여행,지출,3199,449861
2021,9,8,여행,수입,2504,452365
2021,11,29,여행,수입,6048,458413
2020,6,10,식사,수입,7233,465646
2023,9,10,체육대회,수입,2004,467650
2021,4,6,MT,수입,6216,473866
2021,2,9,쇼핑,수입,5533,479399
2021,6,28,쇼핑,지출,2893,476506
2020,5,30,여행,지출,6916,469590
2020,8,4,식사,수입,8495,478085
2021,2,1,체육대회,지출,2296,475789
2022,7,21,쇼핑,지출,5297,470492
2020,8,23,체육대회,지출,2225,468267
2023,3,12,MT,지출,4212,464055
2022,2,10,쇼핑,수입,5341,469396
2020,5,18,여행,지출,9239,460157
2022,10,28,체육대회,지출,3177,456980
2023,6,15,MT,지출,9642,447338
2023,5,15,쇼핑,수입,4734,452072
2021,11,29,MT,지출,9040,443032
2022,3,23,쇼핑,수입,4212,447244
2020,2,1,식사,지출,1082,446162
2023,5,28,쇼핑,지출,3376,442786
2022,3,27,여행,수입,6896,449682
2023,3,24,식사,수입,4350,454032
2023,5,25,체육대회,수입,3850,457882
2020,1,20,체육대회,지출,9951,447931
2021,8,24,식사,지출,4571,443360
2020,1,29,MT,수입,5545,448905
2022,12,5,MT,지출,6993,441912
2022,3,10,체육대회,수입,3446,445358
2022,10,10,여행,수입,6111,451469
2022,4,19,체육대회,수입,7419,458888
2023,1,14,쇼핑,지출,1153,457735
2021,11,7,쇼핑,수입,1115,458850
2021,8,4,여행,수입,3907,462757
2023,6,1,식사,지출,7470,455287
2021,6,3,여행,지출,5966,449321
2021,7,1,MT,수입,7919,457240
2021,9,14,식사,수입,6376,463616
2020,5,24,체육대회,지출,5896,457720
2021,5,21,식사,지출,1802,455918
2023,11,9,쇼핑,수입,6292,462210
2022,2,19,여행,지출,5872,456338
2023,2,1,쇼핑,수입,3381,459719
2022,3,7,여행,수입,4866,464585
2021,9,1,식사,수입,7766,472351
2022,3,2,쇼핑,지출,7555,464796
2021,12,14,식사,지출,4882,459914
2022,11,10,체육대회,수입,2725,462639
2022,2,9,MT,수입,6877,469516
2020,10,9,체육대회,지출,4503,465013
2023,9,10,체육대회,수입,9015,474028
2020,8,18,체육대회,수입,8620,482648
2020,6,14,체육대회,수입,6458,489106
2020,4,27,MT,수입,7958,497064
2021,12,22,체육대회,수입,6514,503578
2020,11,28,MT,수입,1398,504976
2020,6,1,MT,수입,5942,510918
2022,6,23,여행,수입,1907,512825
2023,7,10,쇼핑,수입,3366,516191
2020,9,25,쇼핑,지출,8161,508030
2023,11,5,체육대회,지출,6049,501981
2022,12,6,MT,수입,5125,507106
2021,1,27,여행,수입,4016,511122
2023,9,18,MT,지출,9660,501462
2023,12,4,MT,지출,3927,497535
2020,7,3,식사,지출,9281,488254
2023,2,27,쇼핑,수입,5373,493627
2023,1,28,쇼핑,수입,4881,498508
2023,9,14,식사,수입,5291,503799
2021,3,22,MT,수입,4013,507812
2023,4,20,여행,지출,1629,506183
2022,8,6,MT,지출,5709,500474
2020,1,19,여행,지출,3884,496590
2020,8,17,여행,수입,5712,502302
2023,7,10,MT,지출,7765,494537
2022,1,15,식사,지출,8992,485545
2022,6,12,쇼핑,지출,7482,478063
2020,9,9,체육대회,수입,6245,484308
2023,1,4,MT,지출,8177,476131
2023,10,6,체육대회,수입,1836,477967
2023,1,24,체육대회,수입,2269,480236
2022,2,16,식사,수입,4042,484278
2021,2,10,식사,수입,6290,490568
2023,9,23,체육대회,수입,1784,492352
2021,11,16,여행,수입,9175,501527
2020,4,17,식사,지출,5652,495875
2022,8,13,쇼핑,수입,6075,501950
2022,11,3,쇼핑,지출,3682,498268
2023,12,2,체육대회,수입,3375,501643
2020,2,28,쇼핑,지출,3185,498458
2023,3,25,여행,지출,4133,494325
2022,5,27,체육대회,지출,2997,491328
2022,10,23,쇼핑,지출,2764,488564
2023,9,10,체육대회,수입,4867,493431
2020,8,18,쇼핑,지출,2279,491152
2021,8,20,쇼핑,지출,2278,488874
2022,6,3,여행,지출,9545,479329
2023,12,9,체육대회,지출,2262,477067
2023,11,2,체육대회,수입,8807,485874
2020,10,6,MT,수입,4152,490026
2023,6,2,식사,지출,6331,483695
2023,3,6,쇼핑,수입,9563,493258
2021,9,12,체육대회,지출,9871,483387
2020,5,28,식사,지출,2035,481352
2023,10,5,체육대회,수입,3308,484660
2021,2,14,MT,수입,1882,486542
2021,6,14,식사,지출,9190,477352
2022,8,9,여행,수입,2614,479966
2023,11,22,MT,지출,4775,475191
2021,12,28,여행,수입,1826,477017
2023,11,11,식사,수입,2408,479425
2020,4,20,쇼핑,지출,5319,474106
2023,9,1,식사,수입,4658,478764
2022,11,9,체육대회,수입,1407,480171
2021,1,3,쇼핑,지출,1822,478349
2022,2,16,체육대회,수입,4099,482448
2020,7,14,식사,지출,2099,480349
2020,3,12,여행,수입,3636,483985
2022,10,18,MT,수입,9683,493668
2021,6,17,MT,수입,4421,498089
2020,9,19,여행,수입,2168,500257
2022,10,17,체육대회,지출,2570,497687
2022,4,24,식사,지출,5480,492207
2021,9,9,MT,지출,3543,488664
2023,7,15,MT,지출,4293,484371
2022,3,18,체육대회,지출,3613,480758
2023,3,3,여행,수입,2280,483038
2022,9,28,MT,지출,1974,481064
2020,12,4,여행,지출,3984,477080
2023,6,5,식사,수입,6591,483671
2023,10,1,식사,지출,5229,478442
2023,4,24,MT,지출,2557,475885
2020,12,22,식사,수입,4702,480587
2022,1,5,MT,수입,8930,489517
2022,11,12,여행,수입,3088,492605
2023,6,5,여행,지출,5090,487515
2021,2,15,식사,수입,6082,493597
2021,8,25,MT,지출,9087,484510
2020,9,28,식사,수입,2715,487225
2021,4,16,쇼핑,지출,8578,478647
2023,7,12,여행,수입,5494,484141
2023,1,22,체육대회,지출,2134,482007
2023,6,25,체육대회,수입,1869,483876
2023,2,28,쇼핑,수입,8987,492863
2020,8,28,쇼핑,수입,4234,497097
2023,7,18,체육대회,지출,7581,489516
2020,2,14,체육대회,수입,5907,495423
2022,8,6,MT,지출,6187,489236
2021,11,7,체육대회,수입,4811,494047
2022,3,24,쇼핑,수입,9580,503627
2021,8,6,쇼핑,수입,2323,505950
2022,5,14,식사,지출,4212,501738
2021,9,18,여행,수입,6614,508352
2021,7,2,쇼핑,지출,3340,505012
2022,6,17,쇼핑,수입,6368,511380
2021,5,6,식사,수입,3148,514528
2022,3,3,식사,수입,4367,518895
2020,1,21,MT,수입,2344,521239
2023,5,23,체육대회,수입,3511,524750
2023,4,19,체육대회,지출,1593,523157
2022,6,27,MT,지출,2423,520734
2021,1,26,식사,지출,2724,518010
2023,2,16,체육대회,지출,6134,511876
2020,10,13,쇼핑,지출,1118,510758
2023,3,23,MT,지출,6252,504506
2021,6,30,식사,수입,9342,513848
2022,3,26,MT,수입,5288,519136
2020,6,14,식사,지출,8742,510394
2020,1,9,MT,수입,5655,516049
2021,9,14,쇼핑,지출,5398,510651
2020,6,5,체육대회,지출,3857,506794
2021,7,7,체육대회,지출,3223,503571
2020,3,3,체육대회,수입,2129,505700
2022,6,2,여행,지출,1978,503722
2022,3,6,체육대회,수입,9115,512837
2021,2,16,체육대회,수입,3989,516826
2023,12,25,체육대회,수입,9347,526173
2021,1,25,체육대회,수입,1002,527175
2021,12,26,식사,수입,3883,531058
2020,11,4,여행,수입,1525,532583
2022,1,16,여행,수입,8729,541312
2022,10,8,MT,수입,1281,542593
2020,4,4,식사,지출,5822,536771
2020,6,1,여행,수입,8570,545341
2022,8,28,체육대회,지출,6316,539025
2020,7,2,체육대회,수입,4268,543293
2021,8,29,여행,수입,2039,545332
2021,12,4,여행,지출,8294,537038
2020,7,22,쇼핑,수입,2067,539105
2020,8,10,체육대회,지출,2341,536764
2020,12,13,여행,지출,9059,527705
2020,9,1,MT,수입,3130,530835
2023,10,13,MT,지출,2140,528695
2022,8,23,MT,지출,4446,524249
2023,3,18,식사,지출,7782,516467
2022,8,16,MT,지출,5639,510828
2023,6,4,체육대회,수입,4441,515269
2022,7,21,쇼핑,지출,5404,509865
2023,4,15,MT,수입,3036,512901
2022,2,26,쇼핑,수입,1659,514560
2022,4,30,체육대회,지출,9830,504730
2020,9,29,체육대회,수입,1957,506687
2021,5,9,여행,지출,9377,497310
2023,4,28,쇼핑,수입,5425,502735
2020,10,5,여행,지출,9789,492946
2022,6,24,체육대회,수입,8359,501305
2023,3,18,MT,수입,7553,508858
2021,10,18,여행,지출,7306,501552
2022,9,22,쇼핑,수입,2444,503996
2020,3,1,MT,수입,1485,505481
2021,7,25,체육대회,지출,5354,500127
2022,1,30,식사,수입,6201,506328
2022,7,6,MT,수입,5661,511989
2020,8,8,쇼핑,수입,1609,513598
2023,9,2,MT,수입,9707,523305
2022,6,15,여행,수입,3620,526925
2020,3,22,쇼핑,수입,6112,533037
2020,2,24,MT,수입,4998,538035
2022,6,7,MT,지출,6279,531756
2022,3,2,식사,수입,2352,534108
2020,4,15,MT,수입,9315,543423
2023,4,18,식사,지출,6755,536668
2021,1,28,쇼핑,지출,1884,534784
2021,11,9,체육대회,지출,3499,531285
2021,7,21,쇼핑,지출,9322,521963
2021,8,8,쇼핑,지출,3438,518525
2021,5,20,여행,수입,9802,528327
2023,6,15,MT,수입,3946,532273
2023,2,27,쇼핑,지출,3901,528372
2021,10,13,여행,지출,7837,520535
2022,6,23,쇼핑,수입,1345,521880
2021,10,10,여행,지출,7449,514431
2020,2,28,여행,지출,8941,505490
2022,10,16,MT,수입,7301,512791
2022,1,14,쇼핑,수입,7306,520097
2020,10,8,체육대회,지출,9045,511052
2021,2,23,식사,수입,7869,518921
2022,2,7,체육대회,지출,2563,516358
2022,11,26,식사,지출,5020,511338
2021,7,26,체육대회,수입,9004,520342
2022,8,1,MT,수입,1968,522310
2022,4,14,체육대회,지출,8586,513724
2023,5,25,여행,수입,9902,523626
2022,7,30,식사,수입,4695,528321
2021,9,19,쇼핑,수입,3575,531896
2022,1,11,여행,지출,8759,523137
2022,5,20,식사,지출,1800,521337
